date,au_na,au_sa,au_eu,au_af,au_as,au_au,au_ww
2016-03-04,8,0,0,0,0,0,8
2016-03-05,3,0,0,0,0,0,3
2016-03-06,3,0,0,0,0,0,3
2016-03-07,1,0,0,0,0,0,1
2016-03-08,2,0,0,0,0,0,2
2016-03-09,1,0,0,0,0,0,1
2016-03-10,116,76,16,5,75,56,344
2016-03-11,3,1,0,0,8,2,14
2016-03-12,4,1,0,0,9,2,16
2016-03-13,7,0,0,0,0,0,7
2016-03-14,4,0,0,0,0,0,4
2016-03-15,7,0,0,0,0,0,7
2016-03-16,3,2,0,0,5,2,12
2016-03-17,8,6,1,0,9,4,28
2016-03-18,3,2,0,0,6,1,12
2016-03-19,9,0,0,0,0,0,9
2016-03-20,8,0,0,0,0,0,8
2016-03-21,3,0,0,0,0,0,3
2016-03-22,5,0,0,0,0,0,5
2016-03-23,6,2,1,0,9,5,23
2016-03-24,10,5,1,1,13,8,38
2016-03-25,16,5,0,1,18,8,48
2016-03-26,12,9,2,1,12,10,46
2016-03-27,14,10,1,0,13,12,50
2016-03-28,11,8,1,1,9,6,36
2016-03-29,9,3,0,1,16,6,35
2016-03-30,13,7,2,1,11,6,40
2016-03-31,18,14,2,2,11,12,59
2016-04-01,143,100,14,14,144,125,540
2016-04-02,286,101,52,18,211,178,846
2016-04-03,277,237,73,16,278,192,1073
2016-04-04,305,226,27,40,254,182,1034
2016-04-05,122,58,13,11,143,62,409
2016-04-06,91,73,9,12,54,55,294
2016-04-07,85,35,8,11,68,46,253
2016-04-08,205,89,33,19,197,112,655
2016-04-09,316,195,41,16,167,194,929
2016-04-10,349,315,44,48,336,203,1295
2016-04-11,408,130,51,14,441,256,1300
2016-04-12,388,193,37,55,307,179,1159
2016-04-13,474,219,44,36,299,313,1385
2016-04-14,419,190,71,59,441,323,1503
2016-04-15,371,201,69,17,488,279,1425
2016-04-16,363,255,31,24,258,177,1108
2016-04-17,188,76,24,9,135,136,568
2016-04-18,96,51,6,3,124,50,330
2016-04-19,105,59,19,12,63,73,331
2016-04-20,82,30,9,8,97,53,279
2016-04-21,82,43,17,12,59,53,266
2016-04-22,84,56,7,9,35,61,252
2016-04-23,53,28,12,3,80,37,213
2016-04-24,65,43,4,3,59,51,225
2016-04-25,72,26,4,6,82,33,223
2016-04-26,70,45,11,4,37,50,217
2016-04-27,56,42,7,10,60,48,223
2016-04-28,55,30,8,4,48,46,191
2016-04-29,62,38,5,6,47,45,203
2016-04-30,56,36,13,3,44,47,199
2016-05-01,53,32,8,9,66,37,205
2016-05-02,54,36,7,4,76,34,211
2016-05-03,61,40,13,7,45,44,210
2016-05-04,60,21,6,3,94,34,218
2016-05-05,68,50,5,3,54,32,212
2016-05-06,70,47,7,2,53,45,224
2016-05-07,71,38,14,2,65,36,226
2016-05-08,66,31,10,3,66,36,212
2016-05-09,55,21,12,7,75,41,211
2016-05-10,56,37,12,2,60,47,214
2016-05-11,50,43,7,4,60,39,203
2016-05-12,59,42,5,7,28,39,180
2016-05-13,60,35,3,8,54,30,190
2016-05-14,63,25,6,7,44,39,184
2016-05-15,60,27,5,8,49,36,185
2016-05-16,53,37,11,3,51,31,186
2016-05-17,72,39,4,9,35,52,211
2016-05-18,56,34,13,5,53,42,203
2016-05-19,48,20,11,2,69,29,179
2016-05-20,48,31,12,9,44,44,188
2016-05-21,66,33,7,6,79,53,244
2016-05-22,72,39,5,3,86,65,270
2016-05-23,81,71,19,9,76,51,307
2016-05-24,73,61,8,5,68,41,256
2016-05-25,78,36,13,12,62,57,258
2016-05-26,87,60,7,3,67,45,269
2016-05-27,74,30,7,2,61,54,228
2016-05-28,87,57,15,7,34,61,261
2016-05-29,74,44,15,8,61,61,263
2016-05-30,86,41,5,13,89,43,277
2016-05-31,82,34,13,6,47,57,239
2016-06-01,80,27,5,5,79,47,243
2016-06-02,63,39,4,6,83,36,231
2016-06-03,63,48,5,6,33,47,202
2016-06-04,65,31,15,8,54,49,222
2016-06-05,83,58,6,9,34,51,241
2016-06-06,74,35,17,5,84,64,279
2016-06-07,76,31,7,6,67,35,222
2016-06-08,64,61,8,9,45,58,245
2016-06-09,71,39,10,10,66,35,231
2016-06-10,80,54,13,11,55,65,278
2016-06-11,70,40,5,8,73,60,256
2016-06-12,73,58,14,8,53,62,268
2016-06-13,64,45,6,4,62,54,235
2016-06-14,58,26,11,6,81,36,218
2016-06-15,73,50,9,9,62,39,242
2016-06-16,77,41,17,10,44,60,249
2016-06-17,77,36,16,7,52,48,236
2016-06-18,67,55,10,9,54,43,238
2016-06-19,75,36,8,5,86,47,257
2016-06-20,75,31,13,5,61,43,228
2016-06-21,64,28,11,7,64,54,228
2016-06-22,68,26,11,8,46,42,201
2016-06-23,56,27,10,2,66,46,207
2016-06-24,71,45,6,4,45,38,209
2016-06-25,133,47,20,17,122,86,425
2016-06-26,114,65,15,4,64,83,345
2016-06-27,77,49,7,7,52,50,242
2016-06-28,83,62,12,11,66,72,306
2016-06-29,72,51,6,10,59,37,235
2016-06-30,95,40,9,10,93,48,295
2016-07-01,62,23,12,9,69,44,219
2016-07-02,71,25,12,3,78,37,226
2016-07-03,71,26,5,8,72,56,238
2016-07-04,68,37,14,3,47,54,223
2016-07-05,56,19,7,5,55,43,185
2016-07-06,62,39,11,5,54,44,215
2016-07-07,70,31,11,3,41,48,204
2016-07-08,61,44,7,6,52,43,213
2016-07-09,65,51,14,5,37,55,227
2016-07-10,64,47,12,8,38,55,224
2016-07-11,62,58,15,4,72,37,248
2016-07-12,56,29,6,7,52,42,192
2016-07-13,67,30,12,6,44,34,193
2016-07-14,54,29,11,7,64,30,195
2016-07-15,69,45,11,2,30,43,200
2016-07-16,61,27,10,8,62,37,205
2016-07-17,58,40,4,8,62,44,216
2016-07-18,68,47,14,7,46,54,236
2016-07-19,59,24,13,2,79,36,213
2016-07-20,55,24,12,7,79,35,212
2016-07-21,73,45,16,3,48,49,234
2016-07-22,66,30,14,10,66,44,230
2016-07-23,85,53,15,7,58,40,258
2016-07-24,65,41,9,5,73,40,233
2016-07-25,63,32,5,4,77,49,230
2016-07-26,75,23,7,9,60,45,219
2016-07-27,76,35,13,6,60,36,226
2016-07-28,84,52,7,3,53,56,255
2016-07-29,82,39,9,10,116,53,309
2016-07-30,76,58,16,7,77,46,280
2016-07-31,87,59,21,15,85,47,314
2016-08-01,83,49,9,2,58,41,242
2016-08-02,73,44,8,5,48,35,213
2016-08-03,73,50,15,3,35,44,220
2016-08-04,64,32,10,9,56,46,217
2016-08-05,53,29,11,6,59,43,201
2016-08-06,58,46,6,7,60,33,210
2016-08-07,69,26,10,5,95,57,262
2016-08-08,75,49,8,7,67,53,259
2016-08-09,68,28,12,9,58,35,210
2016-08-10,65,21,9,6,63,48,212
2016-08-11,70,24,11,8,59,47,219
2016-08-12,62,32,13,3,54,37,201
2016-08-13,59,33,12,3,75,55,237
2016-08-14,61,25,14,5,95,43,243
2016-08-15,92,58,14,11,38,58,271
2016-08-16,74,58,10,8,48,54,252
2016-08-17,81,53,13,10,45,42,244
2016-08-18,76,42,9,9,49,50,235
2016-08-19,63,54,8,5,79,41,250
2016-08-20,86,50,8,5,49,63,261
2016-08-21,97,31,19,6,91,51,295
2016-08-22,73,51,14,3,96,54,291
2016-08-23,71,29,15,5,96,44,260
2016-08-24,83,55,8,11,36,49,242
2016-08-25,81,26,14,4,67,44,236
2016-08-26,64,41,6,6,57,32,206
2016-08-27,71,24,5,5,58,50,213
2016-08-28,73,35,9,8,62,43,230
2016-08-29,70,42,8,4,84,53,261
2016-08-30,72,44,13,12,42,58,241
2016-08-31,92,30,13,13,69,49,266
2016-09-01,87,33,13,9,54,59,255
2016-09-02,67,28,11,7,78,58,249
2016-09-03,102,32,15,12,61,72,294
2016-09-04,118,82,22,16,88,57,383
2016-09-05,119,110,24,12,114,99,478
2016-09-06,116,46,12,21,142,90,427
2016-09-07,79,45,16,8,74,59,281
2016-09-08,79,23,4,3,80,39,228
2016-09-09,71,49,11,9,38,44,222
2016-09-10,73,28,11,8,77,42,239
2016-09-11,77,42,20,12,76,73,300
2016-09-12,79,70,7,11,75,42,284
2016-09-13,91,53,11,6,46,63,270
2016-09-14,63,52,7,2,40,50,214
2016-09-15,68,43,10,8,34,45,208
2016-09-16,59,41,13,4,59,35,211
2016-09-17,56,27,5,4,94,38,224
2016-09-18,68,27,18,2,86,65,266
2016-09-19,66,39,7,12,72,62,258
2016-09-20,61,45,8,7,58,37,216
2016-09-21,53,47,5,4,37,47,193
2016-09-22,61,52,11,6,36,49,215
2016-09-23,62,42,7,4,50,51,216
2016-09-24,75,39,10,3,68,42,237
2016-09-25,65,34,7,10,66,49,231
2016-09-26,81,42,11,3,63,62,262
2016-09-27,68,30,9,3,64,52,226
2016-09-28,71,30,9,4,55,52,221
2016-09-29,75,26,9,11,56,49,226
2016-09-30,59,22,5,6,86,38,216
2016-10-01,73,43,15,4,48,49,232
2016-10-02,79,53,6,11,65,49,263
2016-10-03,82,55,10,3,70,40,260
2016-10-04,67,49,6,3,50,38,213
2016-10-05,70,65,18,4,66,52,275
2016-10-06,56,40,6,3,69,45,219
2016-10-07,64,25,13,7,67,39,215
2016-10-08,67,31,4,9,70,36,217
2016-10-09,73,61,10,6,53,48,251
2016-10-10,62,41,13,6,81,42,245
2016-10-11,55,21,13,2,76,47,214
2016-10-12,69,41,11,7,37,38,203
2016-10-13,53,21,14,7,78,30,203
2016-10-14,74,23,10,7,75,40,229
2016-10-15,83,57,17,6,30,55,248
2016-10-16,80,53,10,8,77,71,299
2016-10-17,114,79,11,12,40,72,328
2016-10-18,91,32,19,4,70,61,277
2016-10-19,78,59,19,6,70,57,289
2016-10-20,77,42,18,5,76,56,274
2016-10-21,91,38,11,5,90,76,311
2016-10-22,77,46,21,7,80,71,302
2016-10-23,107,47,15,7,121,87,384
2016-10-24,116,51,20,17,107,60,371
2016-10-25,86,62,15,7,82,59,311
2016-10-26,56,32,4,6,54,32,184
2016-10-27,65,40,9,5,48,46,213
2016-10-28,52,23,8,5,56,37,181
2016-10-29,61,44,4,8,30,44,191
2016-10-30,69,47,4,3,38,45,206
2016-10-31,56,34,5,7,52,40,194
2016-11-01,53,36,10,6,27,43,175
2016-11-02,58,23,9,7,42,40,179
2016-11-03,75,40,10,6,51,41,223
2016-11-04,58,25,12,5,55,30,185
2016-11-05,48,33,8,7,59,28,183
2016-11-06,66,40,6,9,39,35,195
2016-11-07,63,50,8,9,48,40,218
2016-11-08,58,25,10,3,50,46,192
2016-11-09,56,29,11,7,47,46,196
2016-11-10,70,50,7,4,39,36,206
2016-11-11,58,28,3,7,45,33,174
2016-11-12,57,34,10,8,32,35,176
2016-11-13,49,16,3,7,52,29,156
2016-11-14,51,31,8,6,38,43,177
2016-11-15,40,26,6,6,52,31,161
2016-11-16,41,24,9,7,37,38,156
2016-11-17,41,19,3,1,50,37,151
2016-11-18,45,18,4,3,44,35,149
2016-11-19,43,37,3,5,43,36,167
2016-11-20,57,22,4,5,45,32,165
2016-11-21,58,40,6,5,44,28,181
2016-11-22,41,20,11,7,52,32,163
2016-11-23,53,19,10,3,54,31,170
2016-11-24,52,33,9,8,35,31,168
2016-11-25,45,21,10,7,50,28,161
2016-11-26,62,36,11,2,38,32,181
2016-11-27,70,39,5,9,39,47,209
2016-11-28,54,23,10,10,75,39,211
2016-11-29,53,37,10,3,42,39,184
2016-11-30,44,32,8,4,46,37,171
2016-12-01,47,45,5,8,37,43,185
2016-12-02,55,25,13,8,61,29,191
2016-12-03,56,16,8,2,55,26,163
2016-12-04,48,34,11,3,62,28,186
2016-12-05,53,27,3,3,76,33,195
2016-12-06,45,40,8,6,35,34,168
2016-12-07,57,25,11,6,31,39,169
2016-12-08,52,42,10,7,38,32,181
2016-12-09,76,37,17,3,82,49,264
2016-12-10,77,54,9,12,59,65,276
2016-12-11,95,43,13,14,91,48,304
2016-12-12,90,32,15,8,99,51,295
2016-12-13,89,35,19,12,85,45,285
2016-12-14,85,43,14,3,67,58,270
2016-12-15,66,51,5,9,52,49,232
2016-12-16,64,44,12,8,43,55,226
2016-12-17,80,34,14,8,76,59,271
2016-12-18,86,32,6,7,92,64,287
2016-12-19,76,40,14,10,92,59,291
2016-12-20,73,29,6,10,71,59,248
2016-12-21,73,34,7,6,73,54,247
2016-12-22,79,30,8,7,81,40,245
2016-12-23,76,38,12,9,63,36,234
2016-12-24,73,44,8,2,66,42,235
2016-12-25,99,40,13,7,89,63,311
2016-12-26,96,90,8,17,82,72,365
2016-12-27,76,35,14,3,123,49,300
2016-12-28,83,67,14,10,53,65,292
2016-12-29,76,68,18,5,59,55,281
2016-12-30,97,63,18,3,37,62,280
2016-12-31,111,43,15,13,75,73,330
2017-01-01,119,67,11,15,93,58,363
2017-01-02,96,79,25,9,88,68,365
2017-01-03,84,42,16,10,68,68,288
2017-01-04,101,58,14,10,56,69,308
2017-01-05,102,51,19,9,64,56,301
2017-01-06,79,53,15,11,74,50,282
2017-01-07,93,73,12,13,39,76,306
2017-01-08,122,70,22,5,77,78,374
2017-01-09,128,88,23,11,45,85,380
2017-01-10,95,62,18,12,71,57,315
2017-01-11,88,49,17,9,99,49,311
2017-01-12,102,62,11,8,74,60,317
2017-01-13,108,77,15,5,70,55,330
2017-01-14,105,35,9,6,115,56,326
2017-01-15,87,49,17,6,112,69,340
2017-01-16,127,53,9,7,108,71,375
2017-01-17,76,40,15,5,104,44,284
2017-01-18,85,47,10,7,78,69,296
2017-01-19,84,36,14,7,114,47,302
2017-01-20,93,44,13,8,75,51,284
2017-01-21,99,34,17,7,95,46,298
2017-01-22,103,71,19,5,42,75,315
2017-01-23,104,42,19,6,58,71,300
2017-01-24,99,59,13,10,69,44,294
2017-01-25,76,68,19,6,65,48,282
2017-01-26,84,44,8,9,65,52,262
2017-01-27,91,34,15,4,66,68,278
2017-01-28,79,69,14,12,80,57,311
2017-01-29,94,40,19,9,95,68,325
2017-01-30,111,86,30,8,106,103,444
2017-01-31,115,69,19,13,59,71,346
2017-02-01,105,39,10,4,123,84,365
2017-02-02,124,45,23,14,149,92,447
2017-02-03,108,69,14,7,122,65,385
2017-02-04,122,77,17,15,107,77,415
2017-02-05,170,75,20,6,121,101,493
2017-02-06,133,56,20,17,161,115,502
2017-02-07,112,69,18,13,106,66,384
2017-02-08,119,60,11,17,104,62,373
2017-02-09,138,72,10,14,76,92,402
2017-02-10,123,51,25,12,90,64,365
2017-02-11,128,65,14,9,99,91,406
2017-02-12,129,64,13,23,153,112,494
2017-02-13,162,68,22,23,134,79,488
2017-02-14,146,81,29,11,78,113,458
2017-02-15,168,102,13,19,142,88,532
2017-02-16,136,111,22,22,112,104,507
2017-02-17,103,74,14,12,125,59,387
2017-02-18,126,90,18,4,100,107,445
2017-02-19,130,70,20,4,83,71,378
2017-02-20,112,39,23,16,114,70,374
2017-02-21,89,60,17,8,64,70,308
2017-02-22,99,73,16,6,48,65,307
2017-02-23,98,34,18,14,80,76,320
2017-02-24,109,65,6,3,75,69,327
2017-02-25,109,60,20,18,107,56,370
2017-02-26,105,86,18,11,61,77,358
2017-02-27,120,84,17,4,90,66,381
2017-02-28,86,80,7,5,92,55,325
2017-03-01,101,74,6,10,70,64,325
2017-03-02,87,40,8,14,119,74,342
2017-03-03,95,73,21,10,51,74,324
2017-03-04,114,74,19,15,79,72,373
2017-03-05,119,90,27,4,87,97,424
2017-03-06,119,66,25,4,88,67,369
2017-03-07,97,68,9,11,44,75,304
2017-03-08,91,79,13,13,69,58,323
2017-03-09,98,50,17,6,68,54,293
2017-03-10,95,36,12,8,90,54,295
2017-03-11,88,65,14,13,59,72,311
2017-03-12,89,43,21,3,127,73,356
2017-03-13,131,51,18,6,108,63,377
2017-03-14,106,76,19,12,98,60,371
2017-03-15,92,73,24,14,62,85,350
2017-03-16,95,42,22,14,135,63,371
2017-03-17,126,46,15,18,88,89,382
2017-03-18,148,56,18,4,137,80,443
2017-03-19,120,108,30,17,96,93,464
2017-03-20,109,60,16,6,157,88,436
2017-03-21,128,72,22,9,89,75,395
2017-03-22,97,49,19,14,131,75,385
2017-03-23,96,85,16,9,83,87,376
2017-03-24,110,91,16,13,62,76,368
2017-03-25,136,71,11,19,70,94,401
2017-03-26,152,85,14,8,120,84,463
2017-03-27,122,79,24,5,159,78,467
2017-03-28,113,85,23,11,66,92,390
2017-03-29,112,86,17,8,66,70,359
2017-03-30,126,89,8,19,76,82,400
2017-03-31,102,82,23,17,69,93,386
2017-04-01,114,83,20,12,74,75,378
2017-04-02,115,90,9,8,124,75,421
2017-04-03,102,93,9,9,107,86,406
2017-04-04,93,73,16,10,86,71,349
2017-04-05,106,66,24,12,97,84,389
2017-04-06,129,85,25,9,64,69,381
2017-04-07,130,60,14,11,104,64,383
2017-04-08,124,51,9,8,108,73,373
2017-04-09,127,60,26,7,129,96,445
2017-04-10,112,62,8,15,111,93,401
2017-04-11,117,70,12,16,97,74,386
2017-04-12,128,65,20,8,96,73,390
2017-04-13,107,83,18,6,93,62,369
2017-04-14,101,36,14,15,114,78,358
2017-04-15,112,72,26,7,90,82,389
2017-04-16,109,69,24,5,120,70,397
2017-04-17,138,47,15,18,102,103,423
2017-04-18,106,70,18,11,122,63,390
2017-04-19,103,74,8,13,106,84,388
2017-04-20,121,63,22,8,82,88,384
2017-04-21,131,93,18,10,68,82,402
2017-04-22,137,98,12,6,115,75,443
2017-04-23,125,54,28,12,156,95,470
2017-04-24,122,67,24,6,146,78,443
2017-04-25,118,64,20,11,156,102,471
2017-04-26,127,104,12,18,128,97,486
2017-04-27,127,86,29,21,132,85,480
2017-04-28,150,70,10,7,151,82,470
2017-04-29,138,89,32,12,90,119,480
2017-04-30,127,90,19,11,98,82,427
2017-05-01,147,89,24,15,93,102,470
2017-05-02,140,72,14,7,113,109,455
2017-05-03,116,48,15,8,161,92,440
2017-05-04,161,115,16,13,96,73,474
2017-05-05,143,52,10,18,149,66,438
2017-05-06,129,99,21,11,97,66,423
2017-05-07,129,50,26,12,158,74,449
2017-05-08,145,70,28,8,91,106,448
2017-05-09,106,54,20,4,144,76,404
2017-05-10,125,65,19,13,94,88,404
2017-05-11,128,57,24,20,111,82,422
2017-05-12,133,79,14,17,103,70,416
2017-05-13,106,82,11,12,108,81,400
2017-05-14,114,85,15,18,134,90,456
2017-05-15,156,51,19,16,136,81,459
2017-05-16,112,48,27,20,119,87,413
2017-05-17,142,85,12,6,107,74,426
2017-05-18,136,105,26,9,63,99,438
2017-05-19,105,91,23,17,85,88,409
2017-05-20,132,55,16,18,121,80,422
2017-05-21,160,90,22,9,83,98,462
2017-05-22,129,47,13,6,146,85,426
2017-05-23,134,42,18,5,104,87,390
2017-05-24,115,92,24,13,74,73,391
2017-05-25,380,192,41,15,394,201,1223
2017-05-26,4269,2812,988,647,3766,2813,15295
2017-05-27,9704,3964,2199,366,11626,6227,34086
2017-05-28,14677,4665,2803,577,9580,10446,42748
2017-05-29,12954,8763,1421,2211,12085,9163,46597
2017-05-30,12647,7229,1427,785,9649,5988,37725
2017-05-31,9917,5966,892,664,12362,6881,36682
2017-06-01,11687,4005,1336,747,14413,6556,38744
2017-06-02,12178,3932,2255,1067,10150,5564,35146
2017-06-03,6407,2980,1103,732,9594,4271,25087
2017-06-04,7250,3302,1367,860,5822,3467,22068
2017-06-05,7099,4122,1153,1040,6571,3764,23749
2017-06-06,6324,3744,845,523,3332,4687,19455
2017-06-07,4790,3352,764,863,4597,4712,19078
2017-06-08,5781,3757,659,750,4640,3137,18724
2017-06-09,5291,2198,1103,284,5296,3748,17920
2017-06-10,5835,2296,980,504,5080,3121,17816
2017-06-11,4941,3319,1115,650,5445,3939,19409
2017-06-12,6296,2188,469,509,4730,4146,18338
2017-06-13,4544,2513,670,595,3737,3652,15711
2017-06-14,5239,4010,405,231,2493,3967,16345
2017-06-15,4442,3803,719,191,4529,3314,16998
2017-06-16,5329,3720,1223,819,3335,3420,17846
2017-06-17,6966,4202,622,342,3571,5030,20733
2017-06-18,6524,3327,1335,826,5479,4624,22115
2017-06-19,6902,4581,1407,937,2320,5248,21395
2017-06-20,5269,2616,1266,475,6648,3024,19298
2017-06-21,4731,4461,427,238,4772,3714,18343
2017-06-22,4830,2911,751,783,5231,4069,18575
2017-06-23,6444,2094,1239,709,6148,2978,19612
2017-06-24,5380,3260,1118,551,7137,3454,20900
2017-06-25,6455,5343,1527,849,3217,4608,21999
2017-06-26,6942,5258,1501,637,4900,3429,22667
2017-06-27,7182,3694,794,697,5075,3313,20755
2017-06-28,5928,2288,1257,809,5223,3402,18907
2017-06-29,7423,4202,497,503,5849,6057,24531
2017-06-30,6554,2333,407,601,6765,3210,19870
2017-07-01,6573,4330,1156,956,3309,5291,21615
2017-07-02,7193,5420,839,848,5668,4029,23997
2017-07-03,7249,5150,805,513,7128,3941,24786
2017-07-04,5884,3738,1107,1109,7136,3939,22913
2017-07-05,5714,2296,548,552,9370,4188,22668
2017-07-06,7812,2732,1313,812,5760,4453,22882
2017-07-07,5645,4586,1029,619,5931,4210,22020
2017-07-08,7427,4001,712,627,4062,5210,22039
2017-07-09,6975,5179,632,558,4699,5195,23238
2017-07-10,7662,5000,887,508,4849,4436,23342
2017-07-11,5693,3636,1100,232,7443,3342,21446
2017-07-12,7279,2722,1211,324,5995,3656,21187
2017-07-13,7257,4964,1299,778,2217,5036,21551
2017-07-14,7180,4853,955,287,3422,4057,20754
2017-07-15,5432,3466,732,733,6005,4032,20400
2017-07-16,7195,4089,588,941,4582,4290,21685
2017-07-17,6572,2884,1105,910,5423,5089,21983
2017-07-18,5634,3226,1025,683,5848,3883,20299
2017-07-19,6262,4947,1150,300,3171,4598,20428
2017-07-20,5626,4453,1290,423,3662,4283,19737
2017-07-21,4858,4618,386,873,3535,4339,18609
2017-07-22,5055,3024,1023,408,5717,2783,18010
2017-07-23,5085,2641,1197,284,6004,3610,18821
2017-07-24,6386,2891,585,289,5362,3935,19448
2017-07-25,6186,3984,859,467,2957,3389,17842
2017-07-26,4955,3083,1010,788,4529,3340,17705
2017-07-27,5411,2133,572,251,6342,3988,18697
2017-07-28,5241,2587,570,651,5996,2658,17703
2017-07-29,5326,2897,782,537,4920,3242,17704
2017-07-30,5795,2867,1213,190,4235,4355,18655
2017-07-31,5604,3066,1119,773,4595,2976,18133
2017-08-01,4801,2475,775,485,5224,3528,17288
2017-08-02,4406,3642,1103,403,4361,2458,16373
2017-08-03,5074,2459,701,801,3805,3271,16111
2017-08-04,4890,2696,856,563,3785,2786,15576
2017-08-05,4397,1599,638,683,4116,3752,15185
2017-08-06,4186,2523,667,433,5648,2432,15889
2017-08-07,4495,3168,993,312,3057,3897,15922
2017-08-08,4390,3624,499,719,3472,2355,15059
2017-08-09,4317,2741,307,325,4232,2569,14491
2017-08-10,4022,1646,457,485,4215,3504,14329
2017-08-11,4188,3359,695,322,3081,3166,14811
2017-08-12,4297,3417,626,442,2930,3598,15310
2017-08-13,4188,2461,511,436,5249,2462,15307
2017-08-14,4754,3092,493,568,3322,3319,15548
2017-08-15,4929,2949,349,468,3912,2462,15069
2017-08-16,3671,2874,942,614,4126,2420,14647
2017-08-17,4548,1980,829,306,3841,3060,14564
2017-08-18,4476,1503,857,234,4517,2683,14270
2017-08-19,4880,2062,915,529,2776,2944,14106
2017-08-20,4943,2482,816,409,3227,2391,14268
2017-08-21,3608,1839,391,415,5731,2268,14252
2017-08-22,4461,3064,647,338,2318,2767,13595
2017-08-23,4437,1436,849,435,4266,2523,13946
2017-08-24,3846,2219,818,332,4050,2118,13383
2017-08-25,4232,3190,307,542,1783,2831,12885
2017-08-26,3445,3013,874,242,2974,2128,12676
2017-08-27,4362,1724,374,285,3169,2932,12846
2017-08-28,3553,2724,264,296,4284,2006,13127
2017-08-29,3292,2247,266,468,3414,2998,12685
2017-08-30,3305,1204,517,167,4053,2495,11741
2017-08-31,3825,2823,621,376,1929,2722,12296
2017-09-01,3825,2703,802,276,2595,2300,12501
2017-09-02,4289,2203,299,304,2786,2589,12470
2017-09-03,3822,2317,363,417,2914,2794,12627
2017-09-04,3273,1806,734,133,4650,2137,12733
2017-09-05,4020,1747,475,568,2660,2900,12370
2017-09-06,3605,2672,602,215,3097,1979,12170
2017-09-07,3088,2711,760,585,2528,2340,12012
2017-09-08,4073,2000,563,342,1994,2916,11888
2017-09-09,3868,2548,407,599,2100,2587,12109
2017-09-10,3198,2414,519,444,3465,2028,12068
2017-09-11,3669,2308,759,209,3302,1961,12208
2017-09-12,4068,2137,260,259,2899,2134,11757
2017-09-13,3301,2438,658,229,3111,1848,11585
2017-09-14,3349,2454,606,458,2162,2234,11263
2017-09-15,3754,1951,573,418,1840,2469,11005
2017-09-16,3311,2717,699,500,1382,2280,10889
2017-09-17,3607,1438,346,279,3029,2200,10899
2017-09-18,2943,2191,694,420,2798,1820,10866
2017-09-19,2974,1499,469,342,2879,2298,10461
2017-09-20,3220,1045,243,258,4011,1587,10364
2017-09-21,3284,2030,612,359,1897,2254,10436
2017-09-22,2562,1699,441,308,3293,1946,10249
2017-09-23,2840,2047,584,323,2966,1637,10397
2017-09-24,2661,2310,419,154,2759,2011,10314
2017-09-25,2768,2451,354,515,2679,1558,10325
2017-09-26,3511,1970,347,468,1548,2569,10413
2017-09-27,2972,2075,522,150,2211,2469,10399
2017-09-28,3245,2014,362,317,2766,1682,10386
2017-09-29,2728,1971,504,144,2854,1970,10171
2017-09-30,3323,2376,562,464,1070,2291,10086
2017-10-01,2962,2527,529,258,1488,2511,10275
2017-10-02,2678,2155,717,419,2825,1621,10415
2017-10-03,3286,1462,676,263,2571,2198,10456
2017-10-04,3032,2289,624,119,1888,2191,10143
2017-10-05,2710,1114,307,427,2269,1949,8776
2017-10-06,2668,1024,537,363,2626,1923,9141
2017-10-07,3153,1959,546,294,1109,1955,9016
2017-10-08,2859,942,633,250,3006,1364,9054
2017-10-09,2993,1440,378,426,2395,1372,9004
2017-10-10,2513,1809,419,395,2157,1754,9047
2017-10-11,2359,1290,474,394,2146,2192,8855
2017-10-12,2620,1044,342,262,2644,2051,8963
2017-10-13,2380,1725,344,264,2082,2090,8885
2017-10-14,3120,2061,469,330,1484,1472,8936
2017-10-15,2259,1697,494,266,2507,1480,8703
2017-10-16,2678,1957,601,222,1873,1455,8786
2017-10-17,2524,1864,189,138,1841,2045,8601
2017-10-18,2661,1496,186,169,2398,1651,8561
2017-10-19,2250,1191,360,278,3180,1373,8632
2017-10-20,2481,1667,282,236,2040,1919,8625
2017-10-21,2806,1088,383,406,1878,1795,8356
2017-10-22,2598,1760,585,228,2247,1323,8741
2017-10-23,2497,978,298,300,3039,1935,9047
2017-10-24,2470,2006,297,310,2038,1655,8776
2017-10-25,2645,1359,312,367,2341,2121,9145
2017-10-26,2506,1658,213,191,2818,1698,9084
2017-10-27,2175,1515,534,386,1705,1786,8101
2017-10-28,2406,1858,179,193,2328,1454,8418
2017-10-29,2174,1169,324,102,2770,1891,8430
2017-10-30,2336,2123,284,263,1775,1916,8697
2017-10-31,2954,1037,515,166,2082,1963,8717
2017-11-01,2564,1413,440,165,2465,1799,8846
2017-11-02,2674,1145,191,305,2627,1962,8904
2017-11-03,2260,1951,194,249,2456,1916,9026
2017-11-04,2755,2043,348,141,2178,1506,8971
2017-11-05,3055,2007,514,257,1568,1490,8891
2017-11-06,3206,1653,549,130,2176,1604,9318
2017-11-07,3010,1713,532,402,1456,2178,9291
2017-11-08,2546,1337,575,178,3065,1694,9395
2017-11-09,2651,1200,505,214,3293,1804,9667
2017-11-10,3044,2170,242,340,1691,2116,9603
2017-11-11,2818,1365,595,162,2397,2127,9464
2017-11-12,2628,1588,436,411,2722,1878,9663
2017-11-13,2444,1247,373,129,3605,1977,9775
2017-11-14,3028,1336,623,278,2482,2192,9939
2017-11-15,2524,1933,297,101,2925,2199,9979
2017-11-16,2866,1599,581,242,2712,1836,9836
2017-11-17,3187,2225,201,233,2224,1686,9756
2017-11-18,2573,2257,634,459,2147,1552,9622
2017-11-19,2755,1210,563,469,3080,1626,9703
2017-11-20,2975,2458,260,132,2234,1830,9889
2017-11-21,2852,1937,464,383,1860,2361,9857
2017-11-22,3160,1746,411,179,2606,1730,9832
2017-11-23,2510,1172,620,426,3573,1593,9894
2017-11-24,3309,2470,385,356,1275,2312,10107
2017-11-25,2457,1089,201,366,4008,1626,9747
2017-11-26,2855,1073,192,104,3110,2170,9504
2017-11-27,2785,1940,225,117,2968,1472,9507
2017-11-28,3030,1148,217,209,2954,1800,9358
2017-11-29,3198,1118,406,361,2492,1942,9517
2017-11-30,2356,1082,461,297,2670,1276,8142
2017-12-01,2784,1259,587,163,2536,1535,8864
2017-12-02,3068,1354,324,282,2605,1372,9005
2017-12-03,2636,1540,419,171,2496,1744,9006
2017-12-04,2417,2153,435,414,1733,2192,9344
2017-12-05,2619,2290,565,425,1324,1986,9209
2017-12-06,3092,1569,437,443,1506,2341,9388
2017-12-07,3194,971,215,192,3038,1713,9323
2017-12-08,3207,1991,420,361,1973,1448,9400
2017-12-09,3184,1210,530,157,2177,2012,9270
2017-12-10,3339,975,276,177,3197,1734,9698
2017-12-11,3532,2476,528,381,1550,1819,10286
2017-12-12,2943,2275,657,222,2283,1727,10107
2017-12-13,2932,1193,216,256,3378,2250,10225
2017-12-14,3196,1194,621,387,3390,1846,10634
2017-12-15,3030,1090,695,173,4067,1768,10823
2017-12-16,3574,1998,567,115,2574,1996,10824
2017-12-17,3415,1993,440,136,2664,2594,11242
2017-12-18,4101,1238,548,411,3491,1933,11722
2017-12-19,3245,2037,432,558,2999,2053,11324
2017-12-20,3485,2956,277,418,3092,2199,12427
2017-12-21,3133,1884,412,597,3285,2950,12261
2017-12-22,3915,2853,746,142,2265,2439,12360
2017-12-23,3867,2420,346,159,3511,2000,12303
2017-12-24,3811,2737,823,345,2718,2448,12882
2017-12-25,4451,3111,441,530,1375,2980,12888
2017-12-26,3186,2528,366,136,3955,2272,12443
2017-12-27,4160,2022,590,585,2976,1893,12226
2017-12-28,4165,2918,861,571,884,3027,12426
2017-12-29,3709,1686,644,134,3204,2804,12181
2017-12-30,3392,1380,324,265,4597,1945,11903
2017-12-31,3164,2447,350,324,3718,2103,12106
2018-01-01,4364,2700,794,499,2054,2162,12573
2018-01-02,3179,2425,732,456,3653,1911,12356
2018-01-03,3856,1944,419,198,3110,1958,11485
2018-01-04,4088,1826,286,197,3447,2385,12229
2018-01-05,3873,1798,608,133,4539,2109,13060
2018-01-06,4122,2457,266,600,2493,2922,12860
2018-01-07,4051,3356,723,325,2132,3075,13662
2018-01-08,4037,2506,967,332,3830,2378,14050
2018-01-09,4261,1447,649,480,3724,2718,13279
2018-01-10,4183,1996,884,258,3128,3106,13555
2018-01-11,3938,1739,367,675,3925,3332,13976
2018-01-12,4669,1589,882,555,2759,3064,13518
2018-01-13,4432,2045,871,193,3356,2809,13706
2018-01-14,3640,2576,511,587,3649,2489,13452
2018-01-15,4227,1953,1008,246,4234,3035,14703
2018-01-16,4071,2735,380,274,4526,2137,14123
2018-01-17,4927,1821,653,417,3491,2947,14256
2018-01-18,4967,2094,478,715,2981,3673,14908
2018-01-19,4476,3725,1050,295,2529,3086,15161
2018-01-20,4788,3226,443,158,2909,3493,15017
2018-01-21,5227,2990,1062,394,2400,3818,15891
2018-01-22,4645,3277,1057,767,2539,3768,16053
2018-01-23,4280,3034,665,553,4175,2449,15156
2018-01-24,3911,3001,306,312,4458,2435,14423
2018-01-25,4370,1465,466,705,4600,2660,14266
2018-01-26,4583,3308,823,572,2339,2160,13785
2018-01-27,3941,3163,847,350,2828,2908,14037
2018-01-28,3951,3267,938,653,2724,3116,14649
2018-01-29,4313,1590,989,355,4304,3652,15203
2018-01-30,4289,2123,980,376,4111,2772,14651
2018-01-31,3906,1724,1013,258,4945,2667,14513
2018-02-01,3570,1602,909,181,5652,2290,14204
2018-02-02,4950,3377,728,598,1740,2852,14245
2018-02-03,4830,3311,292,181,3146,2308,14068
2018-02-04,3641,2092,557,523,4356,3381,14550
2018-02-05,4150,2211,977,610,3886,3437,15271
2018-02-06,5079,2701,667,386,2945,3041,14819
2018-02-07,4648,3425,346,379,2811,2541,14150
2018-02-08,3978,2135,502,270,3807,2824,13516
2018-02-09,3366,1669,393,188,5319,2329,13264
2018-02-10,4506,1713,399,320,4576,2623,14137
2018-02-11,4026,2295,951,351,4480,2710,14813
2018-02-12,5349,1779,411,258,3769,3731,15297
2018-02-13,3987,2392,404,519,4461,2694,14457
2018-02-14,4106,2688,581,717,4197,2174,14463
2018-02-15,3911,3282,333,396,3221,3543,14686
2018-02-16,4319,2944,988,415,4073,2804,15543
2018-02-17,4896,3698,705,310,2671,3309,15589
2018-02-18,4733,2056,980,272,5506,2623,16170
2018-02-19,5636,3757,576,533,2759,3466,16727
2018-02-20,4428,2643,928,784,4179,2944,15906
2018-02-21,4925,2834,603,232,4312,2758,15664
2018-02-22,4353,2137,626,550,5519,2984,16169
2018-02-23,4049,3977,792,730,3691,2840,16079
2018-02-24,4834,2808,1066,301,2859,3866,15734
2018-02-25,4687,2123,670,272,5649,2665,16066
2018-02-26,5078,2408,735,685,4896,3240,17042
2018-02-27,4788,2766,818,184,4653,2715,15924
2018-02-28,5387,2374,701,361,3962,3091,15876
2018-03-01,4289,3847,480,645,3479,3228,15968
2018-03-02,4101,2706,318,203,4821,3608,15757
2018-03-03,4819,1600,336,312,5022,3328,15417
2018-03-04,4036,3511,914,639,4339,2386,15825
2018-03-05,4294,3421,734,790,3640,3571,16450
2018-03-06,4885,2974,1100,414,3196,3279,15848
2018-03-07,4591,2553,993,730,3511,3171,15549
2018-03-08,4662,2660,738,249,3327,3521,15157
2018-03-09,4736,2243,405,312,4623,2645,14964
2018-03-10,3485,3249,281,589,3756,2484,13844
2018-03-11,4734,2319,994,207,3977,2665,14896
2018-03-12,4360,2743,488,219,3721,3292,14823
2018-03-13,4456,2034,609,524,3191,3536,14350
2018-03-14,3902,1819,396,381,5475,2151,14124
2018-03-15,4796,3267,912,576,1658,2691,13900
2018-03-16,3754,1614,365,293,5347,2489,13862
2018-03-17,4703,1394,587,571,4543,2084,13882
2018-03-18,3839,1751,507,667,4376,3253,14393
2018-03-19,4219,2761,806,202,4147,2606,14741
2018-03-20,4523,2447,472,667,3626,2239,13974
2018-03-21,4191,2118,708,515,3322,3017,13871
2018-03-22,4747,2024,371,658,2931,3115,13846
2018-03-23,4171,2399,799,388,3418,2706,13881
2018-03-24,3467,3138,863,554,2787,2805,13614
2018-03-25,3637,2067,278,191,5259,2317,13749
2018-03-26,4295,3072,732,239,2615,2880,13833
2018-03-27,3586,2627,396,201,3962,2386,13158
2018-03-28,4275,2319,419,372,3190,2545,13120
2018-03-29,4461,2841,771,330,2166,2450,13019
2018-03-30,3851,1681,563,200,3460,3134,12889
2018-03-31,4157,1317,451,479,3868,2737,13009
2018-04-01,4603,1593,360,374,4295,2067,13292
2018-04-02,4217,1949,425,635,4170,2431,13827
2018-04-03,3855,3248,765,609,2021,3089,13587
2018-04-04,4508,1573,889,416,3786,2423,13595
2018-04-05,4188,2531,393,326,3427,2591,13456
2018-04-06,4062,2261,717,210,4012,2057,13319
2018-04-07,3433,2117,402,483,4842,2014,13291
2018-04-08,4823,1433,854,283,2986,3452,13831
2018-04-09,3772,1822,567,421,4118,3391,14091
2018-04-10,3588,3023,737,219,3111,2936,13614
2018-04-11,4235,2732,639,410,2610,2875,13501
2018-04-12,3866,2510,617,129,2902,1885,11909
2018-04-13,3254,2477,496,304,3670,2431,12632
2018-04-14,3402,2770,443,186,2675,3034,12510
2018-04-15,4625,2196,522,264,3429,2203,13239
2018-04-16,3812,1752,670,664,4351,2411,13660
2018-04-17,3592,1567,728,271,4518,2455,13131
2018-04-18,3995,2876,814,514,2897,2261,13357
2018-04-19,4248,2615,887,556,2594,2434,13334
2018-04-20,4585,2186,713,304,2482,3108,13378
2018-04-21,4305,2892,639,600,1920,2457,12813
2018-04-22,3753,1690,364,464,4283,2473,13027
2018-04-23,4465,1678,273,668,3373,3081,13538
2018-04-24,4259,3402,323,225,2382,3114,13705
2018-04-25,3977,1532,626,321,4475,2974,13905
2018-04-26,3416,1852,583,517,4517,2599,13484
2018-04-27,4559,2873,386,503,2574,2353,13248
2018-04-28,3818,1607,855,513,2931,3238,12962
2018-04-29,3884,2715,865,631,2892,2165,13152
2018-04-30,4386,1934,682,603,2565,2855,13025
2018-05-01,3987,2443,823,208,3180,2901,13542
2018-05-02,4232,2110,284,274,4818,2144,13862
2018-05-03,4306,1646,388,422,4299,2545,13606
2018-05-04,4136,2945,699,445,3241,2092,13558
2018-05-05,3392,2610,694,573,3744,2375,13388
2018-05-06,3742,1562,320,382,4796,2687,13489
2018-05-07,3566,2997,409,465,3252,2917,13606
2018-05-08,3443,2430,477,489,3179,3109,13127
2018-05-09,3991,2499,327,265,2422,3115,12619
2018-05-10,3255,1416,308,131,4990,2616,12716
2018-05-11,4196,1373,539,415,3305,2809,12637
2018-05-12,3901,1507,319,534,3919,2302,12482
2018-05-13,4289,2867,452,215,2423,2826,13072
2018-05-14,3957,3191,918,377,2414,2339,13196
2018-05-15,3236,2156,290,301,3762,3142,12887
2018-05-16,4097,1572,785,140,4064,2289,12947
2018-05-17,3953,1486,368,567,3462,3013,12849
2018-05-18,3521,2160,565,155,3529,2716,12646
2018-05-19,3621,2049,853,292,3198,2475,12488
2018-05-20,4333,2425,870,268,1923,3066,12885
2018-05-21,3947,2061,329,610,3936,2208,13091
2018-05-22,3702,1581,809,333,3909,2412,12746
2018-05-23,3682,2155,445,543,2823,3181,12829
2018-05-24,3383,1748,639,269,4184,2345,12568
2018-05-25,4310,1382,291,452,4010,2074,12519
2018-05-26,3356,2518,340,178,3910,2168,12470
2018-05-27,4039,2476,714,387,2567,3222,13405
2018-05-28,4203,1757,610,423,3839,2622,13454
2018-05-29,3894,2523,303,396,3712,1999,12827
2018-05-30,4405,2853,736,198,2730,2229,13151
2018-05-31,4338,2017,786,241,2367,3089,12838
2018-06-01,3300,2214,791,253,3370,2983,12911
2018-06-02,3926,2890,358,171,3437,1999,12781
2018-06-03,3800,3297,764,530,1944,3039,13374
2018-06-04,4423,1885,451,267,3738,2918,13682
2018-06-05,4537,1839,656,235,3231,2805,13303
2018-06-06,3180,2830,485,543,2834,2791,12663
2018-06-07,3655,1433,713,166,3186,2813,11966
2018-06-08,3245,1228,724,425,3980,2622,12224
2018-06-09,3102,2387,745,486,3523,2008,12251
2018-06-10,4151,2810,864,480,2111,2579,12995
2018-06-11,3363,2692,568,246,3930,2356,13155
2018-06-12,4003,3000,739,258,2440,2272,12712
2018-06-13,3298,1618,583,624,4392,2302,12817
2018-06-14,4090,2552,606,237,1729,2718,11932
2018-06-15,4285,2620,835,461,1321,2817,12339
2018-06-16,3997,3123,861,328,1982,2233,12524
2018-06-17,3494,1701,506,477,4796,2029,13003
2018-06-18,3566,1507,811,194,3864,3221,13163
2018-06-19,4343,3002,582,620,1779,2690,13016
2018-06-20,3473,1678,520,458,4532,2007,12668
2018-06-21,3291,2860,449,469,3103,2461,12633
2018-06-22,3179,2114,287,436,4610,2030,12656
2018-06-23,3416,1465,712,412,4644,1912,12561
2018-06-24,4215,3085,515,529,2995,2013,13352
2018-06-25,4357,1388,530,392,3959,3119,13745
2018-06-26,3557,1988,361,590,3772,2882,13150
2018-06-27,4661,3160,516,275,2330,2422,13364
2018-06-28,3456,2942,585,156,3319,2673,13131
2018-06-29,4437,2752,437,511,2046,2820,13003
2018-06-30,3622,3093,869,552,2700,2048,12884
2018-07-01,3838,1379,720,251,3869,3048,13105
2018-07-02,3369,2148,327,467,4618,2303,13232
2018-07-03,3930,2865,788,386,2170,2596,12735
2018-07-04,4176,2135,579,488,2271,2854,12503
2018-07-05,3879,3016,474,616,2384,2142,12511
2018-07-06,3594,1915,247,450,3157,2962,12325
2018-07-07,3614,2574,449,384,2742,2637,12400
2018-07-08,4241,1470,787,473,3772,2113,12856
2018-07-09,4211,1468,710,438,3729,2424,12980
2018-07-10,3605,2674,837,610,2250,2666,12642
2018-07-11,4136,2106,438,640,3412,2130,12862
2018-07-12,4441,1849,351,261,3417,2374,12693
2018-07-13,4184,2853,553,403,1926,2743,12662
2018-07-14,4140,1459,660,295,3474,2808,12836
2018-07-15,3746,3245,759,133,2459,2758,13100
2018-07-16,3514,2114,453,207,4861,2437,13586
2018-07-17,4225,2205,294,388,3767,2168,13047
2018-07-18,4347,2596,700,203,2317,2766,12929
2018-07-19,3287,1890,576,247,3360,2674,12034
2018-07-20,3938,1333,545,217,3157,2974,12164
2018-07-21,3155,2164,556,510,3048,2789,12222
2018-07-22,4136,1576,406,629,3614,2262,12623
2018-07-23,3687,2518,303,175,4018,2049,12750
2018-07-24,3419,2894,723,497,2247,2743,12523
2018-07-25,3847,1800,422,465,3695,2187,12416
2018-07-26,3670,1603,301,523,4347,2006,12450
2018-07-27,3183,1918,777,197,3265,2997,12337
2018-07-28,3572,3117,730,241,2939,1888,12487
2018-07-29,3293,1299,498,212,5252,1927,12481
2018-07-30,4108,1338,537,286,3380,2828,12477
2018-07-31,3504,1490,487,467,4075,2457,12480
2018-08-01,3243,1814,694,527,4056,1868,12202
2018-08-02,3501,1426,604,130,3790,2592,12043
2018-08-03,3221,1718,269,457,4230,2123,12018
2018-08-04,3685,1358,369,152,3829,2476,11869
2018-08-05,4148,1483,678,498,2860,2394,12061
2018-08-06,4232,1879,741,125,2459,2779,12215
2018-08-07,3211,1256,682,473,3563,2686,11871
2018-08-08,3786,1749,640,314,2988,2371,11848
2018-08-09,3814,2620,724,136,1933,2500,11727
2018-08-10,3759,1184,553,184,2813,2791,11284
2018-08-11,3662,2526,440,203,2197,1977,11005
2018-08-12,3108,1653,619,548,3906,1866,11700
2018-08-13,3007,1977,267,418,3946,2324,11939
2018-08-14,3867,1956,666,486,1866,2788,11629
2018-08-15,3331,1634,360,533,3165,2266,11289
2018-08-16,3120,1282,586,301,4204,1838,11331
2018-08-17,3786,2347,571,284,1633,2470,11091
2018-08-18,3529,1694,613,336,2536,2277,10985
2018-08-19,3553,2254,745,445,2306,1886,11189
2018-08-20,3819,2327,609,237,1911,2565,11468
2018-08-21,3324,1271,693,178,3385,2105,10956
2018-08-22,3818,2722,687,202,923,2582,10934
2018-08-23,3518,2435,464,513,1468,2389,10787
2018-08-24,2785,2608,278,125,2534,2449,10779
2018-08-25,3471,1571,558,299,2641,2204,10744
2018-08-26,3283,2699,360,384,2190,2000,10916
2018-08-27,3656,1873,249,343,2920,1956,10997
2018-08-28,2937,2450,518,449,2205,2009,10568
2018-08-29,3054,1525,651,480,2439,2451,10600
2018-08-30,3609,1546,225,234,3281,1674,10569
2018-08-31,2592,1232,624,110,3407,1729,9694
2018-09-01,3285,1559,326,225,2876,1933,10204
2018-09-02,3367,1954,567,444,2669,1610,10611
2018-09-03,3700,2520,466,409,2002,1654,10751
2018-09-04,3353,1741,483,339,2616,1848,10380
2018-09-05,2767,2504,595,426,2165,1842,10299
2018-09-06,3385,2404,285,217,2253,1656,10200
2018-09-07,2877,2059,319,322,2301,2418,10296
2018-09-08,3267,2089,484,135,1951,2279,10205
2018-09-09,3000,2366,323,337,2488,1830,10344
2018-09-10,3251,2105,329,474,2671,1707,10537
2018-09-11,3510,1740,209,316,2430,1993,10198
2018-09-12,3483,1138,206,283,2943,1986,10039
2018-09-13,2720,1816,278,132,3284,1927,10157
2018-09-14,3433,1974,475,105,2349,1592,9928
2018-09-15,2884,2092,624,407,1860,1919,9786
2018-09-16,3229,1862,413,175,2356,1955,9990
2018-09-17,3505,1796,398,374,2187,1757,10017
2018-09-18,2711,1723,432,145,2583,2367,9961
2018-09-19,2817,1378,485,298,2400,2344,9722
2018-09-20,3189,1637,425,174,2274,1938,9637
2018-09-21,2550,1689,360,215,2225,2172,9211
2018-09-22,3206,1947,568,102,2312,1510,9645
2018-09-23,3231,2153,572,106,2315,1548,9925
2018-09-24,3189,2078,703,283,1570,2240,10063
2018-09-25,2767,1850,428,351,2489,2253,10138
2018-09-26,3012,2332,649,182,1933,1743,9851
2018-09-27,2482,1327,595,400,3103,1729,9636
2018-09-28,2876,960,665,119,2608,2334,9562
2018-09-29,3290,1364,263,182,2931,1543,9573
2018-09-30,3152,1169,220,115,3449,1587,9692
2018-10-01,3076,1208,220,399,2871,2041,9815
2018-10-02,2877,1228,393,305,2587,2250,9640
2018-10-03,3388,1009,596,429,2798,1472,9692
2018-10-04,2437,1073,566,252,2959,2255,9542
2018-10-05,2558,1321,385,263,3199,1710,9436
2018-10-06,2618,2026,535,429,2173,1572,9353
2018-10-07,3224,1814,532,358,1915,1550,9393
2018-10-08,3007,1203,544,108,2449,2198,9509
2018-10-09,2708,1141,573,283,2878,1934,9517
2018-10-10,2722,1105,422,195,2918,2186,9548
2018-10-11,2831,2146,490,367,1326,2210,9370
2018-10-12,3211,1797,351,283,2016,1608,9266
2018-10-13,2547,2217,626,459,1850,1530,9229
2018-10-14,2399,1962,553,266,2687,1426,9293
2018-10-15,3232,2345,420,268,1860,1531,9656
2018-10-16,3004,1628,569,98,2312,1745,9356
2018-10-17,2811,1033,507,396,2856,1509,9112
2018-10-18,2857,1138,524,176,2477,1497,8669
2018-10-19,2469,1211,562,446,2619,1618,8925
2018-10-20,2717,1016,244,191,3136,1436,8740
2018-10-21,3050,2145,432,389,914,1877,8807
2018-10-22,3082,2069,217,125,1480,2020,8993
2018-10-23,2719,1411,345,425,1964,1929,8793
2018-10-24,2473,1034,269,305,2814,1823,8718
2018-10-25,2615,1708,210,324,2426,1412,8695
2018-10-26,2711,1221,235,250,2664,1437,8518
2018-10-27,2761,1067,339,134,2672,1239,8212
2018-10-28,2640,1884,548,271,982,1935,8260
2018-10-29,2692,1226,487,332,2384,1327,8448
2018-10-30,2368,1214,407,320,2539,1406,8254
2018-10-31,2824,1611,511,325,1584,1249,8104
2018-11-01,2113,1646,227,86,2088,1847,8007
2018-11-02,2286,1160,327,274,2246,1596,7889
2018-11-03,2493,1025,542,108,2531,1219,7918
2018-11-04,1973,1590,295,138,1920,1948,7864
2018-11-05,2090,1359,422,137,2505,1520,8033
2018-11-06,1975,910,517,365,2656,1418,7841
2018-11-07,2282,1937,185,113,1751,1574,7842
2018-11-08,2289,1951,275,332,1771,1213,7831
2018-11-09,2435,1865,351,159,1305,1533,7648
2018-11-10,2370,1842,279,178,1138,1771,7578
2018-11-11,2468,1787,495,236,1163,1467,7616
2018-11-12,2270,1389,509,174,2037,1298,7677
2018-11-13,2400,1775,366,200,1497,1303,7541
2018-11-14,2375,1875,488,322,855,1617,7532
2018-11-15,2554,1270,351,240,1189,1852,7456
2018-11-16,1904,1779,271,244,1358,1807,7363
2018-11-17,1979,1672,283,150,2093,1167,7344
2018-11-18,2459,833,403,169,1664,1788,7316
2018-11-19,1972,955,467,273,2154,1624,7445
2018-11-20,2299,851,463,144,2210,1153,7120
2018-11-21,1927,1192,164,108,2037,1391,6819
2018-11-22,2005,1210,465,342,1650,1397,7069
2018-11-23,2332,895,317,170,2075,1209,6998
2018-11-24,2309,1083,149,201,2097,1075,6914
2018-11-25,2145,1224,197,207,1963,1117,6853
2018-11-26,2031,1343,237,288,1783,1397,7079
2018-11-27,2219,858,449,208,2004,1223,6961
2018-11-28,1877,1236,162,300,1583,1634,6792
2018-11-29,1856,876,158,254,1985,1592,6721
2018-11-30,2224,1062,169,96,1661,1376,6588
2018-12-01,2020,1489,133,276,1210,1385,6513
2018-12-02,1870,964,445,96,1692,1340,6407
2018-12-03,2203,1014,180,190,1493,1457,6537
2018-12-04,1612,890,357,242,2121,1186,6408
2018-12-05,2180,1053,165,145,1622,1251,6416
2018-12-06,2133,845,374,302,1603,1131,6388
2018-12-07,2205,1511,427,181,618,1408,6350
2018-12-08,2028,858,317,73,1449,1519,6244
2018-12-09,2026,1153,327,233,1335,1044,6118
2018-12-10,2136,1481,321,172,953,1120,6183
2018-12-11,2092,1456,144,199,785,1547,6223
2018-12-12,1927,1360,315,100,1483,1003,6188
2018-12-13,1762,1407,288,94,1292,1368,6211
2018-12-14,1940,1339,148,127,1556,939,6049
2018-12-15,1750,1342,391,145,1510,913,6051
2018-12-16,1501,1184,157,283,1515,1276,5916
2018-12-17,2069,1383,295,163,656,1477,6043
2018-12-18,1980,708,208,184,1862,1044,5986
2018-12-19,2001,676,192,196,1623,1229,5917
2018-12-20,1767,1283,289,268,942,1397,5946
2018-12-21,1643,664,298,147,1837,1292,5881
2018-12-22,1502,642,146,285,1977,1243,5795
2018-12-23,1651,1405,325,217,848,1380,5826
2018-12-24,1802,1430,248,203,699,1423,5805
2018-12-25,1993,1214,189,70,1092,1208,5766
2018-12-26,2002,632,278,229,1703,923,5767
2018-12-27,1767,901,332,121,1547,1084,5752
2018-12-28,1638,977,123,167,1699,1054,5658
2018-12-29,1760,1402,350,217,681,1207,5617
2018-12-30,1837,630,132,104,1644,1262,5609
2018-12-31,1729,756,274,216,1812,922,5709
2019-01-01,1501,1253,184,249,1390,1148,5725
2019-01-02,1718,739,197,185,1688,1040,5567
2019-01-03,1587,796,211,241,1589,1181,5605
2019-01-04,1760,653,131,194,1878,852,5468
2019-01-05,1418,546,287,129,2089,972,5441
2019-01-06,1817,1168,301,169,628,1344,5427
2019-01-07,1633,1124,267,110,1282,1022,5438
2019-01-08,1765,1199,178,236,1051,992,5421
2019-01-09,1606,851,295,183,1664,820,5419
2019-01-10,1870,1249,356,216,705,1050,5446
2019-01-11,1794,618,230,126,1292,1266,5326
2019-01-12,1489,809,269,213,1688,1008,5476
2019-01-13,1646,771,334,183,1765,999,5698
2019-01-14,1489,1198,204,251,1401,1270,5813
2019-01-15,1756,574,320,170,1402,1349,5571
2019-01-16,1706,627,157,120,1753,1210,5573
2019-01-17,1692,665,117,275,1789,1177,5715
2019-01-18,1479,909,137,280,1851,998,5654
2019-01-19,1485,1024,165,67,1733,1264,5738
2019-01-20,1717,1303,199,180,1284,1133,5816
2019-01-21,1710,734,211,167,1648,1401,5871
2019-01-22,1430,1002,127,262,1483,1384,5688
2019-01-23,1780,1112,325,170,1150,1160,5697
2019-01-24,1798,1101,215,113,1362,1153,5742
2019-01-25,1656,920,166,280,1396,1244,5662
2019-01-26,1941,1077,270,252,1221,925,5686
2019-01-27,1467,590,326,225,1949,1209,5766
2019-01-28,1732,953,209,185,1510,1242,5831
2019-01-29,1833,732,331,144,1631,965,5636
2019-01-30,1482,1064,292,110,1447,1233,5628
2019-01-31,1773,812,225,136,1786,878,5610
2019-02-01,1486,605,336,238,1808,1016,5489
2019-02-02,1399,1294,295,205,1084,1245,5522
2019-02-03,1682,935,320,200,1475,1048,5660
2019-02-04,1585,1049,125,61,1647,1346,5813
2019-02-05,1787,1344,265,83,1120,1054,5653
2019-02-06,1523,936,204,220,1316,1371,5570
2019-02-07,1388,756,320,117,1726,1243,5550
2019-02-08,1532,817,129,252,1501,1327,5558
2019-02-09,1403,1331,289,82,1072,1363,5540
2019-02-10,1470,1038,329,219,1215,1403,5674
2019-02-11,1771,873,153,81,2007,921,5806
2019-02-12,1884,1378,375,190,340,1354,5521
2019-02-13,1463,1152,335,144,1158,1232,5484
2019-02-14,1667,1093,313,140,1346,991,5550
2019-02-15,1668,692,265,74,1846,900,5445
2019-02-16,1639,630,158,227,1947,928,5529
2019-02-17,1829,1352,165,105,1277,922,5650
2019-02-18,1960,1372,310,252,872,1071,5837
2019-02-19,1718,1122,241,246,1119,1062,5508
2019-02-20,1584,1094,285,242,1170,1177,5552
2019-02-21,1762,1189,271,245,728,1314,5509
2019-02-22,1603,569,211,254,1867,933,5437
2019-02-23,1809,1132,169,191,1165,992,5458
2019-02-24,1425,810,277,214,1812,1045,5583
2019-02-25,1590,1291,213,57,1325,1203,5679
2019-02-26,1541,838,122,66,1541,1330,5438
2019-02-27,1905,873,286,225,1318,857,5464
2019-02-28,1479,1101,333,133,1548,881,5475
2019-03-01,1867,1331,353,214,746,914,5425
2019-03-02,1565,1339,171,79,1446,840,5440
2019-03-03,1915,701,222,166,1436,1138,5578
2019-03-04,1774,1078,157,252,1109,1271,5641
2019-03-05,1748,1236,243,201,599,1319,5346
2019-03-06,1410,534,294,118,1686,1275,5317
2019-03-07,1614,892,293,67,1246,1189,5301
2019-03-08,1567,808,200,62,1821,837,5295
2019-03-09,1533,1114,143,164,1306,1055,5315
2019-03-10,1860,715,304,187,1019,1344,5429
2019-03-11,1727,1175,273,222,927,1200,5524
2019-03-12,1315,1133,354,137,1434,852,5225
2019-03-13,1475,1058,290,171,1159,1026,5179
2019-03-14,1675,1289,300,109,880,955,5208
2019-03-15,1504,1267,204,131,827,1225,5158
2019-03-16,1538,1196,213,204,646,1101,4898
2019-03-17,1606,930,134,178,1593,813,5254
2019-03-18,1735,939,369,256,827,1257,5383
2019-03-19,1731,719,243,173,1203,1116,5185
2019-03-20,1711,874,133,181,1486,811,5196
2019-03-21,1645,604,355,254,1511,876,5245
2019-03-22,1356,1106,155,251,1414,943,5225
2019-03-23,1513,1197,249,52,1047,1097,5155
2019-03-24,1737,1227,363,126,982,884,5319
2019-03-25,1783,1059,279,171,1254,907,5453
2019-03-26,1664,897,222,178,1272,961,5194
2019-03-27,1323,717,258,167,1965,798,5228
2019-03-28,1533,610,355,180,1660,794,5132
2019-03-29,1277,1273,317,226,832,1175,5100
2019-03-30,1363,1205,251,208,1053,989,5069
2019-03-31,1780,871,131,88,1100,1277,5247
2019-04-01,1643,778,228,88,1247,1298,5282
2019-04-02,1469,583,336,151,1380,1101,5020
2019-04-03,1698,738,350,179,882,1213,5060
2019-04-04,1691,1109,299,137,709,1028,4973
2019-04-05,1706,512,335,157,1036,1222,4968
2019-04-06,1488,1120,308,140,1001,844,4901
2019-04-07,1667,978,336,220,1145,786,5132
2019-04-08,1335,1023,145,205,1395,1199,5302
2019-04-09,1260,862,308,233,1365,934,4962
2019-04-10,1495,717,317,206,1509,961,5205
2019-04-11,1419,661,356,243,1433,1234,5346
2019-04-12,1736,1248,313,195,531,1316,5339
2019-04-13,1467,852,316,73,1483,1120,5311
2019-04-14,1587,1001,297,135,1262,1129,5411
2019-04-15,1796,1240,195,89,845,1271,5436
2019-04-16,1317,1058,145,130,1409,1084,5143
2019-04-17,1525,1263,276,239,1005,907,5215
2019-04-18,1412,1257,125,241,1064,1084,5183
2019-04-19,1375,559,187,94,1819,1174,5208
2019-04-20,1474,678,269,112,1702,1013,5248
2019-04-21,1497,1260,154,204,970,1221,5306
2019-04-22,1457,956,308,223,1390,1153,5487
2019-04-23,1395,1088,312,222,1459,1005,5481
2019-04-24,1410,936,371,238,1277,1313,5545
2019-04-25,1918,746,278,131,1523,1164,5760
2019-04-26,1412,1058,312,139,1353,1292,5566
2019-04-27,1476,609,204,122,2166,913,5490
2019-04-28,1775,1125,267,104,819,1341,5431
2019-04-29,1826,1045,371,179,973,1085,5479
2019-04-30,1596,772,247,110,1783,886,5394
2019-05-01,1837,727,293,124,1648,881,5510
2019-05-02,1547,1124,272,149,1335,1022,5449
2019-05-03,1641,1084,278,69,1024,1346,5442
2019-05-04,1506,1074,246,120,1488,917,5351
2019-05-05,1820,783,382,169,1351,971,5476
2019-05-06,1382,657,202,98,2034,1128,5501
2019-05-07,1579,1044,179,260,1182,1050,5294
2019-05-08,1695,1111,260,190,968,1021,5245
2019-05-09,1543,764,169,89,1822,895,5282
2019-05-10,1604,1001,227,117,1439,809,5197
2019-05-11,1599,547,267,196,1806,840,5255
2019-05-12,1399,790,134,233,2148,869,5573
2019-05-13,1642,584,161,175,1874,1193,5629
2019-05-14,1576,937,249,217,1285,1005,5269
2019-05-15,1618,924,106,200,1269,1014,5131
2019-05-16,1375,793,304,63,1459,1137,5131
2019-05-17,1743,978,202,83,944,1195,5145
2019-05-18,1470,982,115,175,1559,873,5174
2019-05-19,1533,1264,261,121,1215,1034,5428
2019-05-20,1790,929,247,202,1342,970,5480
2019-05-21,1693,1191,352,123,824,1063,5246
2019-05-22,1358,814,271,106,1486,941,4976
2019-05-23,1590,862,132,124,1373,938,5019
2019-05-24,1436,902,132,245,1190,1140,5045
2019-05-25,1564,749,108,52,1618,875,4966
2019-05-26,1665,980,133,196,835,1165,4974
2019-05-27,1630,1102,321,69,977,1024,5123
2019-05-28,1642,641,298,72,1511,750,4914
2019-05-29,1434,1246,341,99,991,908,5019
2019-05-30,1515,547,152,67,1539,1249,5069
2019-05-31,1549,1121,298,112,1043,942,5065
2019-06-01,1559,1107,343,79,1015,912,5015
2019-06-02,1671,1234,161,59,967,1114,5206
2019-06-03,1390,891,366,113,1752,849,5361
2019-06-04,1587,1092,312,210,1008,796,5005
2019-06-05,1748,535,129,115,1314,1236,5077
2019-06-06,1338,1080,293,140,977,1235,5063
2019-06-07,1297,1003,285,185,1301,952,5023
2019-06-08,1662,642,334,53,1406,974,5071
2019-06-09,1702,620,161,57,1867,1004,5411
2019-06-10,1807,1251,349,106,867,972,5352
2019-06-11,1646,1075,237,205,850,1047,5060
2019-06-12,1664,944,247,56,1095,1047,5053
2019-06-13,1551,605,180,224,1516,984,5060
2019-06-14,1713,650,173,184,1178,1089,4987
2019-06-15,1274,921,243,52,1666,895,5051
2019-06-16,1325,763,153,243,1699,1099,5282
2019-06-17,1635,964,200,214,1012,1180,5205
2019-06-18,1780,924,304,251,1100,781,5140
2019-06-19,1632,636,109,71,1490,1036,4974
2019-06-20,1778,669,321,125,1334,877,5104
2019-06-21,1662,953,226,203,1091,885,5020
2019-06-22,1469,976,328,179,1298,755,5005
2019-06-23,1412,1233,203,171,1030,1070,5119
2019-06-24,1516,647,246,72,1799,899,5179
2019-06-25,1488,1008,291,211,925,991,4914
2019-06-26,1709,826,312,146,860,1082,4935
2019-06-27,1312,522,255,170,1492,1076,4827
2019-06-28,1564,1173,151,108,932,905,4833
2019-06-29,1294,507,182,206,1554,1172,4915
2019-06-30,1604,835,353,130,893,1236,5051
2019-07-01,1451,996,331,244,892,1248,5162
2019-07-02,1580,619,221,62,1359,1047,4888
2019-07-03,1323,889,149,207,1220,1091,4879
2019-07-04,1416,813,244,212,1251,872,4808
2019-07-05,1334,910,234,121,1261,981,4841
2019-07-06,1455,800,166,183,1319,959,4882
2019-07-07,1650,758,261,259,1422,873,5223
2019-07-08,1687,1141,359,207,509,1255,5158
2019-07-09,1240,1125,200,186,1148,864,4763
2019-07-10,1454,1122,122,64,1205,890,4857
2019-07-11,1537,572,213,193,1190,1127,4832
2019-07-12,1308,720,214,209,1591,867,4909
2019-07-13,1418,891,245,136,1368,816,4874
2019-07-14,1407,534,285,162,1483,1180,5051
2019-07-15,1525,699,181,236,1571,908,5120
2019-07-16,1554,1175,323,147,695,908,4802
2019-07-17,1333,630,238,231,1211,1151,4794
2019-07-18,1390,821,169,163,1418,810,4771
2019-07-19,1367,1022,262,103,1072,975,4801
2019-07-20,1392,1189,204,137,1168,776,4866
2019-07-21,1409,969,226,162,1549,767,5082
2019-07-22,1672,847,154,218,1188,1044,5123
2019-07-23,1574,839,297,90,887,1067,4754
2019-07-24,1264,717,133,231,1270,1151,4766
2019-07-25,1399,879,254,127,933,1072,4664
2019-07-26,1636,1108,318,101,605,968,4736
2019-07-27,1641,1181,134,216,656,921,4749
2019-07-28,1467,626,134,194,1307,1175,4903
2019-07-29,1273,623,140,96,1861,979,4972
2019-07-30,1458,614,125,106,1497,905,4705
2019-07-31,1347,491,214,191,1512,926,4681
2019-08-01,1651,643,173,97,1129,1028,4721
2019-08-02,1316,1060,111,136,1152,1011,4786
2019-08-03,1462,487,135,57,1562,944,4647
2019-08-04,1654,836,331,114,1158,856,4949
2019-08-05,1471,1069,260,73,1135,988,4996
2019-08-06,1348,641,113,217,1497,874,4690
2019-08-07,1337,903,124,171,1359,810,4704
2019-08-08,1509,889,236,132,936,1020,4722
2019-08-09,1455,580,153,86,1473,912,4659
2019-08-10,1337,937,126,171,1286,822,4679
2019-08-11,1575,873,119,165,1047,1160,4939
2019-08-12,1413,1078,333,86,1326,791,5027
2019-08-13,1274,512,238,164,1364,1111,4663
2019-08-14,1339,901,138,57,1628,732,4795
2019-08-15,1343,686,135,182,1299,1023,4668
2019-08-16,1543,701,275,229,992,1018,4758
2019-08-17,1240,1048,212,87,1197,978,4762
2019-08-18,1643,812,170,221,835,1031,4712
2019-08-19,1253,709,103,133,1725,721,4644
2019-08-20,1178,720,249,66,1601,830,4644
2019-08-21,1483,918,99,209,794,1043,4546
2019-08-22,1510,1132,231,154,492,1044,4563
2019-08-23,1253,477,168,73,1626,964,4561
2019-08-24,1392,703,295,87,1218,817,4512
2019-08-25,1213,1067,157,96,1244,893,4670
2019-08-26,1209,1046,279,204,867,1044,4649
2019-08-27,1229,686,151,187,1435,690,4378
2019-08-28,1359,783,176,67,1089,871,4345
2019-08-29,1497,1022,130,78,880,860,4467
2019-08-30,1133,580,175,74,1610,875,4447
2019-08-31,1290,495,290,165,1287,923,4450
2019-09-01,1365,1120,313,186,585,1030,4599
2019-09-02,1308,1135,211,206,796,925,4581
2019-09-03,1493,995,148,44,652,1107,4439
2019-09-04,1148,457,91,206,1403,1085,4390
2019-09-05,1433,889,192,203,596,1101,4414
2019-09-06,1144,695,168,182,1428,721,4338
2019-09-07,1294,692,92,94,1112,1037,4321
2019-09-08,1299,860,152,151,978,1131,4571
2019-09-09,1474,850,313,83,808,1072,4600
2019-09-10,1382,621,288,103,917,1021,4332
2019-09-11,1343,525,159,168,1204,994,4393
2019-09-12,1282,758,221,103,1120,848,4332
2019-09-13,1144,966,108,185,1075,845,4323
2019-09-14,1524,576,134,123,943,1092,4392
2019-09-15,1456,798,143,70,1009,1042,4518
2019-09-16,1364,553,132,195,1097,1097,4438
2019-09-17,1337,1074,260,107,555,1037,4370
2019-09-18,1420,456,167,211,1254,824,4332
2019-09-19,1353,1052,236,195,632,862,4330
2019-09-20,1363,856,132,185,888,891,4315
2019-09-21,1212,955,284,152,765,907,4275
2019-09-22,1293,564,287,129,1175,737,4185
2019-09-23,1536,744,239,63,1118,736,4436
2019-09-24,1545,578,213,113,1170,839,4458
2019-09-25,1379,943,178,54,710,1055,4319
2019-09-26,1219,573,284,209,1169,845,4299
2019-09-27,1496,637,104,57,1272,797,4363
2019-09-28,1288,525,209,206,1198,959,4385
2019-09-29,1514,457,298,186,1164,836,4455
2019-09-30,1407,491,274,176,1475,751,4574
2019-10-01,1238,891,198,160,987,967,4441
2019-10-02,1130,443,285,168,1511,793,4330
2019-10-03,1453,740,196,61,1092,742,4284
2019-10-04,1485,842,153,180,601,1043,4304
2019-10-05,1158,1054,145,47,1141,812,4357
2019-10-06,1311,996,254,84,1126,698,4469
2019-10-07,1223,570,110,196,1705,720,4524
2019-10-08,1260,848,250,193,1082,701,4334
2019-10-09,1145,969,214,134,979,897,4338
2019-10-10,1361,884,152,73,896,946,4312
2019-10-11,1517,596,98,195,1017,937,4360
2019-10-12,1350,846,148,107,918,968,4337
2019-10-13,1219,487,287,50,1554,786,4383
2019-10-14,1150,777,145,46,1536,702,4356
2019-10-15,1382,594,238,173,749,1040,4176
2019-10-16,1375,754,275,198,512,1004,4118
2019-10-17,1174,808,275,190,897,804,4148
2019-10-18,1286,665,204,189,1132,621,4097
2019-10-19,1357,836,268,110,821,732,4124
2019-10-20,1437,576,109,198,1112,681,4113
2019-10-21,1268,803,179,123,1024,860,4257
2019-10-22,1367,787,108,116,904,823,4105
2019-10-23,1216,834,158,74,779,1016,4077
2019-10-24,1043,684,117,100,1340,825,4109
2019-10-25,1135,983,141,158,657,949,4023
2019-10-26,1256,627,148,146,1152,683,4012
2019-10-27,1199,880,271,142,935,607,4034
2019-10-28,1065,966,262,86,1000,630,4009
2019-10-29,1313,735,271,152,575,924,3970
2019-10-30,1191,462,213,119,1186,832,4003
2019-10-31,1149,662,231,128,1132,688,3990
2019-11-01,979,457,186,88,1258,932,3900
2019-11-02,1332,517,205,102,1042,700,3898
2019-11-03,1199,955,230,100,709,709,3902
2019-11-04,1329,477,158,75,1236,658,3933
2019-11-05,1074,486,253,109,1326,649,3897
2019-11-06,1231,721,265,49,632,964,3862
2019-11-07,1012,753,91,165,1113,904,4038
2019-11-08,1280,822,113,70,992,655,3932
2019-11-09,1269,892,211,131,469,864,3836
2019-11-10,1243,902,138,146,645,722,3796
2019-11-11,1061,768,113,149,968,759,3818
2019-11-12,1205,840,249,132,681,713,3820
2019-11-13,1153,820,233,41,868,725,3840
2019-11-14,1025,633,112,82,988,926,3766
2019-11-15,1066,429,136,187,1073,908,3799
2019-11-16,1188,606,244,99,838,760,3735
2019-11-17,966,473,176,59,1214,942,3830
2019-11-18,1094,795,187,102,950,725,3853
2019-11-19,999,395,177,158,1195,960,3884
2019-11-20,1335,824,99,185,532,941,3916
2019-11-21,1063,607,108,171,1200,875,4024
2019-11-22,1109,423,268,143,1119,818,3880
2019-11-23,1068,823,218,111,977,760,3957
2019-11-24,1216,656,256,173,943,711,3955
2019-11-25,1187,929,191,45,1005,669,4026
2019-11-26,1306,974,84,128,701,718,3911
2019-11-27,1144,919,174,79,707,832,3855
2019-11-28,1023,961,207,83,725,900,3899
2019-11-29,1068,822,97,149,923,798,3857
2019-11-30,1129,769,99,98,938,941,3974
2019-12-01,1294,947,237,127,538,708,3851
2019-12-02,1174,415,123,109,1177,970,3968
2019-12-03,1279,808,120,61,968,772,4008
2019-12-04,1022,467,245,87,1257,925,4003
2019-12-05,1342,651,247,183,850,727,4000
2019-12-06,1046,479,237,126,1131,927,3946
2019-12-07,1201,580,80,90,1130,868,3949
2019-12-08,1266,966,139,46,971,645,4033
2019-12-09,1023,514,89,191,1435,735,3987
2019-12-10,1400,824,233,119,539,935,4050
2019-12-11,1053,541,268,193,1135,801,3991
2019-12-12,1137,629,186,166,1100,844,4062
2019-12-13,1313,853,256,118,482,975,3997
2019-12-14,1373,984,167,126,507,850,4007
2019-12-15,1229,557,126,98,1363,745,4118
2019-12-16,1445,493,269,73,897,1008,4185
2019-12-17,1280,646,251,60,784,935,3956
2019-12-18,1081,477,94,177,1620,684,4133
2019-12-19,1219,957,167,148,573,987,4051
2019-12-20,1342,718,240,152,634,968,4054
2019-12-21,1217,614,97,183,1028,863,4002
2019-12-22,1051,458,187,49,1637,747,4129
2019-12-23,1391,617,139,125,1095,755,4122
2019-12-24,1188,580,197,75,1259,768,4067
2019-12-25,1254,539,275,192,878,939,4077
2019-12-26,1072,932,262,79,763,918,4026
2019-12-27,1040,905,90,59,1229,621,3944
2019-12-28,1142,467,114,143,1475,647,3988
2019-12-29,1091,810,171,146,1213,612,4043
2019-12-30,1201,472,247,172,1338,652,4082
2019-12-31,1101,670,132,121,1310,716,4050
2020-01-01,1312,772,202,101,640,959,3986
2020-01-02,1138,499,200,93,1112,903,3945
2020-01-03,1204,525,269,176,1100,652,3926
2020-01-04,1276,686,203,157,717,857,3896
2020-01-05,1334,634,93,68,1233,811,4173
2020-01-06,1326,820,201,133,737,940,4157
2020-01-07,1355,666,196,161,780,730,3888
2020-01-08,1342,854,199,83,514,947,3939
2020-01-09,1346,945,210,52,499,881,3933
2020-01-10,1213,425,176,54,1401,617,3886
2020-01-11,1012,385,90,75,1315,956,3833
2020-01-12,1290,608,243,81,971,818,4011
2020-01-13,1179,955,206,185,686,706,3917
2020-01-14,1199,926,244,133,542,716,3760
2020-01-15,989,908,103,162,1039,588,3789
2020-01-16,1059,588,225,110,966,843,3791
2020-01-17,1240,673,118,110,877,773,3791
2020-01-18,1060,631,187,155,990,695,3718
2020-01-19,1100,839,113,68,926,909,3955
2020-01-20,1194,594,241,178,1063,587,3857
2020-01-21,1056,785,260,91,832,707,3731
2020-01-22,1257,390,91,83,1076,790,3687
2020-01-23,978,392,237,166,1101,893,3767
2020-01-24,1047,907,84,116,703,874,3731
2020-01-25,1241,662,223,160,787,771,3844
2020-01-26,1068,427,108,89,1592,626,3910
2020-01-27,1271,795,177,92,844,740,3919
2020-01-28,1235,687,197,79,913,593,3704
2020-01-29,1088,432,74,45,1415,663,3717
2020-01-30,1091,531,130,89,1182,587,3610
2020-01-31,1119,707,193,116,564,861,3560
2020-02-01,909,508,186,99,1139,702,3543
2020-02-02,1035,453,82,39,1186,807,3602
2020-02-03,1288,816,78,116,695,692,3685
2020-02-04,1154,445,111,51,969,755,3485
2020-02-05,1089,492,231,132,695,862,3501
2020-02-06,1063,365,142,165,1063,696,3494
2020-02-07,1170,597,77,147,863,590,3444
2020-02-08,911,473,98,58,1085,851,3476
2020-02-09,1205,850,178,131,585,526,3475
2020-02-10,1036,842,229,123,329,835,3394
2020-02-11,1065,342,215,75,1044,663,3404
2020-02-12,1136,516,180,142,600,811,3385
2020-02-13,962,721,102,173,688,835,3481
2020-02-14,1217,647,102,100,578,851,3495
2020-02-15,1181,371,212,148,1075,551,3538
2020-02-16,1133,831,204,139,683,642,3632
2020-02-17,1163,829,218,75,523,877,3685
2020-02-18,1183,502,138,171,907,769,3670
2020-02-19,1014,619,157,49,869,895,3603
2020-02-20,1012,368,180,173,1340,564,3637
2020-02-21,1120,495,133,64,1103,738,3653
2020-02-22,1124,890,114,46,749,726,3649
2020-02-23,967,653,107,146,1303,640,3816
2020-02-24,964,717,168,171,884,902,3806
2020-02-25,926,718,117,120,844,856,3581
2020-02-26,1208,474,221,163,721,775,3562
2020-02-27,943,433,73,47,1404,704,3604
2020-02-28,1004,468,125,157,1281,535,3570
2020-02-29,1181,663,73,43,983,607,3550
2020-03-01,1023,375,172,100,1332,659,3661
2020-03-02,1143,399,226,153,1128,683,3732
2020-03-03,1026,858,139,144,590,754,3511
2020-03-04,1100,460,71,109,1185,575,3500
2020-03-05,1064,749,177,169,611,784,3554
2020-03-06,1020,409,81,42,1349,583,3484
2020-03-07,938,757,149,98,889,775,3606
2020-03-08,945,623,158,145,1178,628,3677
2020-03-09,1213,439,88,47,1085,796,3668
2020-03-10,1089,725,226,169,719,609,3537
2020-03-11,947,837,129,169,783,723,3588
2020-03-12,975,686,94,48,1205,544,3552
2020-03-13,1166,569,160,156,857,637,3545
2020-03-14,996,797,217,35,706,766,3517
2020-03-15,1107,799,145,91,633,874,3649
2020-03-16,1017,561,127,71,1135,738,3649
2020-03-17,1198,792,187,84,718,531,3510
2020-03-18,918,780,89,158,891,714,3550
2020-03-19,1141,783,155,59,640,719,3497
2020-03-20,1063,554,87,137,935,677,3453
2020-03-21,1157,463,179,61,791,825,3476
2020-03-22,1195,653,147,141,780,659,3575
2020-03-23,1083,366,126,97,1305,652,3629
2020-03-24,1148,475,83,54,1183,551,3494
2020-03-25,899,443,105,161,1038,861,3507
2020-03-26,945,428,241,98,1250,652,3614
2020-03-27,1198,662,75,46,1035,563,3579
2020-03-28,1008,764,129,51,687,855,3494
2020-03-29,1038,885,150,118,749,607,3547
2020-03-30,1153,647,218,116,761,651,3546
2020-03-31,1077,753,187,124,639,642,3422
2020-04-01,1107,610,178,132,723,649,3399
2020-04-02,1064,739,108,112,815,557,3395
2020-04-03,904,701,77,146,728,822,3378
2020-04-04,1041,691,198,46,669,693,3338
2020-04-05,1022,746,156,168,884,583,3559
2020-04-06,1242,564,179,161,704,703,3553
2020-04-07,958,778,83,106,885,575,3385
2020-04-08,1024,777,132,152,531,757,3373
2020-04-09,951,452,211,158,775,823,3370
2020-04-10,975,567,126,63,801,808,3340
2020-04-11,1062,543,182,153,736,685,3361
2020-04-12,1011,372,149,102,1257,526,3417
2020-04-13,1102,706,150,168,734,568,3428
2020-04-14,979,722,122,85,743,660,3311
2020-04-15,950,402,121,143,1002,661,3279
2020-04-16,1138,448,177,36,879,643,3321
2020-04-17,944,578,120,65,1060,562,3329
2020-04-18,1136,499,68,163,896,531,3293
2020-04-19,902,663,113,76,734,799,3287
2020-04-20,907,383,136,109,1038,736,3309
2020-04-21,880,609,79,133,1054,606,3361
2020-04-22,1120,714,85,64,785,547,3315
2020-04-23,1056,357,133,75,1048,650,3319
2020-04-24,835,349,179,69,1274,562,3268
2020-04-25,966,502,182,144,768,725,3287
2020-04-26,1134,400,189,128,717,729,3297
2020-04-27,853,644,81,44,1167,536,3325
2020-04-28,831,370,222,123,987,764,3297
2020-04-29,1044,620,152,99,405,714,3034
2020-04-30,848,449,117,91,917,665,3087
2020-05-01,1008,751,207,144,372,698,3180
2020-05-02,949,470,71,66,939,644,3139
2020-05-03,856,583,114,153,985,486,3177
2020-05-04,833,493,188,104,1078,492,3188
2020-05-05,850,445,204,118,947,488,3052
2020-05-06,780,313,211,78,1178,546,3106
2020-05-07,1040,531,99,42,818,570,3100
2020-05-08,854,599,121,110,858,572,3114
2020-05-09,971,310,89,66,969,665,3070
2020-05-10,872,786,78,62,756,624,3178
2020-05-11,856,688,86,51,996,515,3192
2020-05-12,951,520,208,34,597,739,3049
2020-05-13,793,377,140,85,1091,577,3063
2020-05-14,998,719,154,93,532,580,3076
2020-05-15,902,531,95,149,703,720,3100
2020-05-16,969,755,157,48,574,589,3092
2020-05-17,1036,429,190,81,785,661,3182
2020-05-18,829,624,153,32,1026,497,3161
2020-05-19,943,750,158,135,380,711,3077
2020-05-20,974,484,131,40,895,495,3019
2020-05-21,879,514,136,54,835,594,3012
2020-05-22,978,521,72,47,682,692,2992
2020-05-23,759,641,83,134,926,483,3026
2020-05-24,999,740,204,69,394,703,3109
2020-05-25,810,555,120,92,1017,532,3126
2020-05-26,1033,444,69,58,770,621,2995
2020-05-27,766,439,180,73,873,725,3056
2020-05-28,906,304,93,44,1030,639,3016
2020-05-29,768,526,159,45,777,681,2956
2020-05-30,923,394,101,121,950,513,3002
2020-05-31,821,596,209,138,609,689,3062
2020-06-01,833,422,178,134,865,689,3121
2020-06-02,828,440,63,39,900,726,2996
2020-06-03,859,601,142,119,833,464,3018
2020-06-04,1020,672,107,120,401,720,3040
2020-06-05,793,564,143,150,908,483,3041
2020-06-06,789,381,122,46,1197,503,3038
2020-06-07,849,650,89,38,979,494,3099
2020-06-08,1038,507,66,150,739,555,3055
2020-06-09,890,697,194,48,382,718,2929
2020-06-10,880,462,90,85,884,608,3009
2020-06-11,892,687,133,142,498,634,2986
2020-06-12,769,588,195,142,794,458,2946
2020-06-13,803,630,177,71,684,589,2954
2020-06-14,865,630,97,90,731,616,3029
2020-06-15,926,311,72,53,1239,476,3077
2020-06-16,944,348,206,68,979,499,3044
2020-06-17,889,579,175,99,639,641,3022
2020-06-18,754,352,70,56,1175,594,3001
2020-06-19,920,426,202,48,788,583,2967
2020-06-20,1033,676,193,96,438,594,3030
2020-06-21,825,624,128,84,762,648,3071
2020-06-22,847,331,116,47,1043,637,3021
2020-06-23,913,565,117,103,717,576,2991
2020-06-24,904,312,197,91,874,609,2987
2020-06-25,966,595,88,82,763,485,2979
2020-06-26,857,322,102,33,923,743,2980
2020-06-27,773,557,183,37,710,622,2882
2020-06-28,956,327,193,76,618,642,2812
2020-06-29,750,622,123,41,727,705,2968
2020-06-30,1002,585,124,139,402,641,2893
2020-07-01,824,607,153,104,724,451,2863
2020-07-02,807,632,140,96,642,562,2879
2020-07-03,887,482,155,59,636,630,2849
2020-07-04,883,454,157,114,773,477,2858
2020-07-05,783,318,178,90,1008,509,2886
2020-07-06,898,440,122,144,651,646,2901
2020-07-07,921,635,60,47,564,656,2883
2020-07-08,913,598,129,102,463,676,2881
2020-07-09,720,288,104,137,1050,530,2829
2020-07-10,880,432,156,132,707,521,2828
2020-07-11,886,306,171,87,834,571,2855
2020-07-12,1018,422,90,97,839,476,2942
2020-07-13,1032,368,80,81,922,476,2959
2020-07-14,856,601,82,134,631,557,2861
2020-07-15,866,459,168,134,737,568,2932
2020-07-16,895,570,120,50,726,590,2951
2020-07-17,964,306,174,37,1076,466,3023
2020-07-18,956,624,128,46,654,526,2934
2020-07-19,831,598,159,136,657,506,2887
2020-07-20,982,505,201,56,550,657,2951
2020-07-21,897,651,75,57,738,538,2956
2020-07-22,769,689,99,89,591,703,2940
2020-07-23,931,354,59,40,1083,515,2982
2020-07-24,830,652,154,106,710,450,2902
2020-07-25,892,436,180,131,783,549,2971
2020-07-26,997,370,72,46,795,606,2886
2020-07-27,944,698,90,132,501,562,2927
2020-07-28,957,446,206,139,760,451,2959
2020-07-29,771,327,118,60,1086,493,2855
2020-07-30,855,733,112,96,523,625,2944
2020-07-31,943,597,189,128,616,491,2964
2020-08-01,787,666,115,71,778,521,2938
2020-08-02,857,413,85,34,856,653,2898
2020-08-03,971,582,70,125,477,692,2917
2020-08-04,871,325,64,128,1029,550,2967
2020-08-05,1003,474,182,106,611,523,2899
2020-08-06,884,461,119,88,700,677,2929
2020-08-07,735,664,187,113,473,690,2862
2020-08-08,785,549,73,89,857,537,2890
2020-08-09,970,397,126,129,673,605,2900
2020-08-10,803,401,182,124,736,703,2949
2020-08-11,816,393,137,48,939,615,2948
2020-08-12,743,478,184,100,947,472,2924
2020-08-13,952,381,136,115,667,656,2907
2020-08-14,927,490,125,82,628,651,2903
2020-08-15,986,711,180,111,253,651,2892
2020-08-16,941,457,64,43,704,685,2894
2020-08-17,942,305,114,99,925,446,2831
2020-08-18,841,588,195,77,720,451,2872
2020-08-19,963,373,136,52,868,531,2923
2020-08-20,977,541,113,67,706,542,2946
2020-08-21,947,642,167,131,286,705,2878
2020-08-22,737,408,117,125,1006,489,2882
2020-08-23,757,376,105,133,892,589,2852
2020-08-24,733,409,78,94,954,659,2927
2020-08-25,871,722,64,59,682,537,2935
2020-08-26,923,658,176,95,609,440,2901
2020-08-27,789,299,132,113,955,598,2886
2020-08-28,984,510,99,35,609,609,2846
2020-08-29,966,685,71,76,694,454,2946
2020-08-30,809,539,95,127,767,531,2868
2020-08-31,1016,364,74,67,890,520,2931
2020-09-01,873,358,97,125,737,690,2880
2020-09-02,784,371,151,130,832,622,2890
2020-09-03,973,442,63,134,626,619,2857
2020-09-04,773,532,104,83,803,596,2891
2020-09-05,894,655,66,116,455,658,2844
2020-09-06,747,616,140,83,795,421,2802
2020-09-07,733,691,173,103,760,467,2927
2020-09-08,811,511,95,104,727,637,2885
2020-09-09,787,500,194,107,569,716,2873
2020-09-10,947,688,193,28,389,613,2858
2020-09-11,808,663,65,33,870,464,2903
2020-09-12,722,484,146,116,707,682,2857
2020-09-13,872,351,97,99,1001,480,2900
2020-09-14,833,638,107,83,783,480,2924
2020-09-15,894,335,152,61,853,586,2881
2020-09-16,884,458,141,67,898,464,2912
2020-09-17,799,585,83,68,914,436,2885
2020-09-18,786,323,189,139,897,603,2937
2020-09-19,767,440,90,131,854,665,2947
2020-09-20,760,388,188,60,869,712,2977
2020-09-21,930,716,71,59,624,577,2977
2020-09-22,818,518,153,143,639,697,2968
2020-09-23,841,732,72,130,746,451,2972
2020-09-24,999,491,146,129,754,481,3000
2020-09-25,952,526,184,128,565,622,2977
2020-09-26,801,641,123,133,751,496,2945
2020-09-27,837,706,163,133,551,576,2966
2020-09-28,815,594,100,101,723,773,3106
2020-09-29,891,503,156,73,850,642,3115
2020-09-30,987,737,165,120,542,544,3095
2020-10-01,785,622,72,54,779,741,3053
2020-10-02,919,445,155,84,1009,480,3092
2020-10-03,825,366,213,126,1032,523,3085
2020-10-04,990,479,167,155,776,592,3159
2020-10-05,853,679,165,136,549,739,3121
2020-10-06,1014,665,201,43,496,653,3072
2020-10-07,817,550,154,135,772,648,3076
2020-10-08,994,755,180,118,313,755,3115
2020-10-09,837,339,157,74,1203,561,3171
2020-10-10,873,491,171,112,969,575,3191
2020-10-11,840,781,145,127,636,648,3177
2020-10-12,957,552,130,145,831,549,3164
2020-10-13,936,424,158,35,1015,686,3254
2020-10-14,1019,383,100,62,911,721,3196
2020-10-15,821,513,97,70,1119,594,3214
2020-10-16,983,670,116,114,536,782,3201
2020-10-17,879,611,155,52,858,672,3227
2020-10-18,882,633,119,62,1054,494,3244
2020-10-19,988,780,157,76,600,638,3239
2020-10-20,1110,714,171,147,341,709,3192
2020-10-21,1095,607,80,125,497,745,3149
2020-10-22,826,510,79,145,830,794,3184
2020-10-23,1047,466,127,51,792,664,3147
2020-10-24,946,739,132,67,625,768,3277
2020-10-25,1095,679,76,148,438,776,3212
2020-10-26,1040,736,111,86,552,704,3229
2020-10-27,915,418,156,101,1068,494,3152
2020-10-28,818,553,160,41,1101,502,3175
2020-10-29,1037,602,196,136,474,697,3142
2020-10-30,1119,508,97,85,845,576,3230
2020-10-31,936,607,151,95,836,581,3206
2020-11-01,970,445,158,78,961,552,3164
2020-11-02,1011,508,221,126,653,675,3194
2020-11-03,1042,505,176,95,712,735,3265
2020-11-04,1041,664,205,72,751,505,3238
2020-11-05,1015,349,151,42,1029,542,3128
2020-11-06,854,429,72,126,1128,543,3152
2020-11-07,1102,405,189,102,892,518,3208
2020-11-08,814,663,198,107,791,516,3089
2020-11-09,870,601,119,145,902,498,3135
2020-11-10,1026,744,150,49,672,532,3173
2020-11-11,873,582,78,144,722,767,3166
2020-11-12,914,701,69,141,672,699,3196
2020-11-13,919,515,199,35,754,772,3194
2020-11-14,922,542,176,73,857,491,3061
2020-11-15,867,615,71,47,830,606,3036
2020-11-16,979,532,204,141,786,466,3108
2020-11-17,935,647,206,80,757,529,3154
2020-11-18,979,525,97,35,910,572,3118
2020-11-19,1027,598,153,81,611,616,3086
2020-11-20,876,475,195,67,841,634,3088
2020-11-21,804,724,145,84,617,629,3003
2020-11-22,840,365,191,101,1117,473,3087
2020-11-23,1071,448,190,141,680,621,3151
2020-11-24,802,564,136,141,981,475,3099
2020-11-25,787,626,116,65,767,739,3100
2020-11-26,885,382,146,120,854,692,3079
2020-11-27,1084,572,187,132,535,632,3142
2020-11-28,773,639,201,43,955,466,3077
2020-11-29,919,640,121,139,787,502,3108
2020-11-30,926,761,189,97,551,642,3166
2020-12-01,915,519,120,108,950,523,3135
2020-12-02,1043,674,215,147,329,690,3098
2020-12-03,973,332,102,31,1076,558,3072
2020-12-04,934,392,134,86,949,550,3045
2020-12-05,939,522,170,117,622,675,3045
2020-12-06,987,358,198,145,593,755,3036
2020-12-07,1034,628,104,72,597,679,3114
2020-12-08,998,490,166,68,634,647,3003
2020-12-09,812,468,154,133,984,482,3033
2020-12-10,1041,752,208,33,286,771,3091
2020-12-11,927,454,131,125,873,599,3109
2020-12-12,822,390,75,122,926,746,3081
2020-12-13,822,597,191,131,722,627,3090
2020-12-14,801,601,120,130,845,688,3185
2020-12-15,802,717,61,61,848,536,3025
2020-12-16,830,411,194,70,923,690,3118
2020-12-17,833,318,88,146,1180,621,3186
2020-12-18,988,341,81,45,953,694,3102
2020-12-19,975,673,152,125,466,706,3097
2020-12-20,846,471,72,114,861,734,3098
2020-12-21,891,537,194,41,908,542,3113
2020-12-22,837,765,120,35,864,513,3134
2020-12-23,805,355,210,125,964,671,3130
2020-12-24,921,369,186,94,1008,459,3037
2020-12-25,819,532,158,65,843,581,2998
2020-12-26,863,491,109,141,783,667,3054
2020-12-27,1043,757,211,87,464,729,3291
2020-12-28,1075,439,65,94,887,614,3174
2020-12-29,1011,546,183,149,507,679,3075
2020-12-30,1055,762,123,110,318,707,3075
2020-12-31,833,672,107,70,857,479,3018
2021-01-01,1040,444,171,42,847,458,3002
2021-01-02,917,642,86,85,794,518,3042
2021-01-03,907,315,197,115,838,723,3095
2021-01-04,997,758,181,105,394,665,3100
2021-01-05,936,600,91,102,851,552,3132
2021-01-06,827,550,195,109,770,659,3110
2021-01-07,1043,686,205,78,453,610,3075
2021-01-08,852,700,85,41,755,630,3063
2021-01-09,995,413,121,70,784,692,3075
2021-01-10,965,648,105,121,555,710,3104
2021-01-11,934,703,215,63,571,682,3168
2021-01-12,958,438,133,43,904,554,3030
2021-01-13,876,567,89,143,906,477,3058
2021-01-14,885,752,103,73,484,716,3013
2021-01-15,845,527,165,133,777,551,2998
2021-01-16,1022,473,125,53,910,464,3047
2021-01-17,1110,527,75,36,809,634,3191
2021-01-18,865,725,187,70,839,492,3178
2021-01-19,878,664,100,69,659,661,3031
2021-01-20,958,359,159,89,928,511,3004
2021-01-21,831,368,98,125,983,621,3026
2021-01-22,785,375,96,124,1056,563,2999
2021-01-23,1023,675,68,104,399,711,2980
2021-01-24,1050,559,118,51,511,753,3042
2021-01-25,819,466,84,92,1079,520,3060
2021-01-26,752,540,124,98,731,725,2970
2021-01-27,877,632,168,34,515,726,2952
2021-01-28,898,637,105,143,450,675,2908
2021-01-29,894,421,64,73,792,657,2901
2021-01-30,957,518,122,92,520,714,2923
2021-01-31,803,613,109,69,740,636,2970
2021-02-01,776,651,92,83,848,597,3047
2021-02-02,986,657,150,53,402,606,2854
2021-02-03,965,576,62,78,589,574,2844
2021-02-04,868,506,192,71,584,722,2943
2021-02-05,843,496,169,93,878,479,2958
2021-02-06,760,414,160,42,1029,508,2913
2021-02-07,967,660,136,38,712,481,2994
2021-02-08,943,440,191,72,923,548,3117
2021-02-09,1028,517,118,61,685,549,2958
2021-02-10,817,697,160,79,553,559,2865
2021-02-11,756,695,100,99,569,678,2897
2021-02-12,856,689,194,104,551,518,2912
2021-02-13,820,588,71,113,746,545,2883
2021-02-14,880,716,145,120,514,612,2987
2021-02-15,1030,375,163,42,744,766,3120
2021-02-16,826,593,99,131,639,583,2871
2021-02-17,978,650,148,45,614,460,2895
2021-02-18,858,505,110,121,608,723,2925
2021-02-19,788,330,107,118,952,537,2832
2021-02-20,921,619,164,35,572,560,2871
2021-02-21,963,497,149,129,767,462,2967
2021-02-22,968,664,76,59,700,483,2950
2021-02-23,815,467,159,122,582,662,2807
2021-02-24,869,491,97,126,711,547,2841
2021-02-25,760,435,175,108,853,486,2817
2021-02-26,778,313,117,109,1009,515,2841
2021-02-27,874,334,182,43,865,547,2845
2021-02-28,775,559,78,82,788,577,2859
2021-03-01,1002,341,156,80,899,495,2973
2021-03-02,931,572,130,127,425,667,2852
2021-03-03,925,656,113,59,570,581,2904
2021-03-04,900,565,107,29,749,527,2877
2021-03-05,915,582,174,52,485,618,2826
2021-03-06,966,661,73,87,602,472,2861
2021-03-07,1006,692,61,139,589,479,2966
2021-03-08,1017,668,149,81,578,548,3041
2021-03-09,856,561,140,130,502,627,2816
2021-03-10,917,574,99,127,497,615,2829
2021-03-11,902,577,70,95,593,669,2906
2021-03-12,921,653,119,71,472,601,2837
2021-03-13,901,306,156,48,1008,486,2905
2021-03-14,896,341,144,63,984,527,2955
2021-03-15,890,730,95,46,639,586,2986
2021-03-16,960,417,154,107,670,501,2809
2021-03-17,816,539,94,54,911,457,2871
2021-03-18,745,706,200,32,482,712,2877
2021-03-19,755,630,156,64,656,604,2865
2021-03-20,982,357,161,111,780,467,2858
2021-03-21,884,652,171,112,582,577,2978
2021-03-22,812,582,155,116,698,619,2982
2021-03-23,813,433,155,41,876,631,2949
2021-03-24,991,656,78,36,744,452,2957
2021-03-25,983,395,132,46,689,687,2932
2021-03-26,919,301,119,77,817,742,2975
2021-03-27,944,710,76,55,696,566,3047
2021-03-28,1023,693,188,139,415,538,2996
2021-03-29,945,488,85,46,835,583,2982
2021-03-30,902,284,163,128,876,454,2807
2021-03-31,903,338,121,46,946,430,2784
2021-04-01,885,460,154,78,705,555,2837
2021-04-02,843,571,190,45,518,663,2830
2021-04-03,720,679,187,62,597,607,2852
2021-04-04,825,596,166,106,602,558,2853
2021-04-05,898,376,93,55,771,712,2905
2021-04-06,834,483,190,46,684,621,2858
2021-04-07,892,341,62,33,1049,440,2817
2021-04-08,727,484,104,101,952,448,2816
2021-04-09,728,561,117,116,852,464,2838
2021-04-10,864,383,167,44,736,623,2817
2021-04-11,908,567,167,67,529,645,2883
2021-04-12,995,385,186,44,849,508,2967
2021-04-13,836,306,190,105,730,620,2787
2021-04-14,805,462,79,105,873,428,2752
2021-04-15,937,317,59,66,947,441,2767
2021-04-16,737,652,78,30,635,680,2812
2021-04-17,762,660,96,44,656,564,2782
2021-04-18,788,650,106,110,675,498,2827
2021-04-19,820,366,108,138,727,650,2809
2021-04-20,916,382,150,43,575,679,2745
2021-04-21,896,530,61,69,650,532,2738
2021-04-22,969,296,117,130,669,636,2817
2021-04-23,962,425,100,56,798,448,2789
2021-04-24,706,571,72,85,658,646,2738
2021-04-25,952,637,151,37,532,490,2799
2021-04-26,803,611,121,81,696,577,2889
2021-04-27,783,679,128,99,476,636,2801
2021-04-28,804,595,184,118,491,526,2718
2021-04-29,744,272,96,60,1120,433,2725
2021-04-30,868,367,180,48,691,546,2700
2021-05-01,716,647,104,118,628,489,2702
2021-05-02,711,541,60,32,944,507,2795
2021-05-03,729,558,97,131,662,609,2786
2021-05-04,767,441,101,51,749,532,2641
2021-05-05,732,268,83,78,979,424,2564
2021-05-06,726,505,90,61,762,494,2638
2021-05-07,724,464,152,63,763,433,2599
2021-05-08,861,350,83,75,619,574,2562
2021-05-09,837,330,158,116,811,466,2718
2021-05-10,702,322,74,59,927,625,2709
2021-05-11,831,397,128,90,763,413,2622
2021-05-12,844,455,68,66,643,534,2610
2021-05-13,881,579,101,107,359,497,2524
2021-05-14,682,306,110,103,771,600,2572
2021-05-15,877,494,68,53,643,414,2549
2021-05-16,774,469,97,58,754,583,2735
2021-05-17,768,356,180,62,780,550,2696
2021-05-18,774,512,135,95,618,500,2634
2021-05-19,736,515,163,95,641,415,2565
2021-05-20,904,351,124,46,561,599,2585
2021-05-21,829,522,93,96,382,611,2533
2021-05-22,742,615,134,72,609,423,2595
2021-05-23,800,551,90,110,462,536,2549
2021-05-24,889,518,93,69,463,585,2617
2021-05-25,861,287,58,68,593,597,2464
2021-05-26,887,456,104,36,588,523,2594
2021-05-27,788,268,174,94,820,401,2545
2021-05-28,841,419,82,116,582,506,2546
2021-05-29,863,446,91,81,547,481,2509
2021-05-30,640,282,64,55,977,518,2536
2021-05-31,854,378,97,124,552,578,2583
2021-06-01,880,626,119,78,337,483,2523
2021-06-02,781,430,139,90,434,584,2458
2021-06-03,786,593,71,54,348,557,2409
2021-06-04,848,386,162,86,459,547,2488
2021-06-05,762,326,91,118,622,546,2465
2021-06-06,827,494,140,78,571,403,2513
2021-06-07,681,268,88,50,988,467,2542
2021-06-08,637,324,94,60,783,534,2432
2021-06-09,839,493,63,97,460,549,2501
2021-06-10,807,546,101,76,507,418,2455
2021-06-11,776,246,157,92,690,457,2418
2021-06-12,635,322,128,101,776,476,2438
2021-06-13,712,360,160,70,533,554,2389
2021-06-14,653,479,106,102,652,446,2438
2021-06-15,650,470,137,81,638,557,2533
2021-06-16,770,317,128,46,748,405,2414
2021-06-17,628,347,94,112,838,474,2493
2021-06-18,827,327,137,111,555,527,2484
2021-06-19,623,335,82,67,928,363,2398
2021-06-20,731,511,122,73,539,491,2467
2021-06-21,844,284,82,48,833,406,2497
2021-06-22,639,239,50,80,799,589,2396
2021-06-23,708,337,111,50,575,576,2357
2021-06-24,709,290,49,77,775,436,2336
2021-06-25,744,355,90,55,598,588,2430
2021-06-26,761,254,129,87,785,399,2415
2021-06-27,802,384,94,44,631,466,2421
2021-06-28,726,604,155,63,303,598,2449
2021-06-29,817,416,102,31,582,445,2393
2021-06-30,732,469,127,105,493,464,2390
2021-07-01,770,513,81,58,416,531,2369
2021-07-02,810,285,164,63,580,474,2376
2021-07-03,684,250,143,112,659,447,2295
2021-07-04,768,407,94,63,620,396,2348
2021-07-05,652,464,63,35,612,600,2426
2021-07-06,666,361,106,99,720,377,2329
2021-07-07,589,345,65,116,814,411,2340
2021-07-08,693,433,134,83,652,368,2363
2021-07-09,627,286,157,97,830,361,2358
2021-07-10,792,390,126,95,543,421,2367
2021-07-11,634,277,167,73,854,408,2413
2021-07-12,704,267,123,103,647,534,2378
2021-07-13,790,522,139,108,245,527,2331
2021-07-14,711,300,51,99,767,369,2297
2021-07-15,664,382,111,110,700,429,2396
2021-07-16,665,292,53,108,694,542,2354
2021-07-17,603,332,111,115,678,481,2320
2021-07-18,591,282,78,37,841,525,2354
2021-07-19,828,486,125,66,411,471,2387
2021-07-20,777,573,105,75,351,435,2316
2021-07-21,628,558,132,93,534,419,2364
2021-07-22,767,442,137,67,314,535,2262
2021-07-23,773,477,120,111,279,495,2255
2021-07-24,701,379,101,79,673,370,2303
2021-07-25,710,481,87,60,514,524,2376
2021-07-26,707,245,140,68,703,508,2371
2021-07-27,617,439,52,29,780,391,2308
2021-07-28,596,379,66,64,685,531,2321
2021-07-29,755,499,146,72,313,522,2307
2021-07-30,695,484,163,103,380,527,2352
2021-07-31,631,492,136,75,589,497,2420
2021-08-01,673,411,143,75,441,534,2277
2021-08-02,726,409,47,49,571,505,2307
2021-08-03,720,266,131,37,809,353,2316
2021-08-04,668,576,73,41,468,554,2380
2021-08-05,718,534,143,89,432,407,2323
2021-08-06,636,353,104,106,596,550,2345
2021-08-07,648,373,130,26,583,575,2335
2021-08-08,694,273,147,81,590,508,2293
2021-08-09,787,417,60,27,707,378,2376
2021-08-10,750,263,67,111,711,389,2291
2021-08-11,722,383,88,38,532,477,2240
2021-08-12,714,509,128,102,313,411,2177
2021-08-13,632,245,111,33,840,387,2248
2021-08-14,734,553,50,103,466,349,2255
2021-08-15,569,410,111,66,651,446,2253
2021-08-16,619,528,94,105,542,360,2248
2021-08-17,730,477,91,46,330,515,2189
2021-08-18,689,233,91,63,758,401,2235
2021-08-19,645,385,89,43,617,398,2177
2021-08-20,629,493,138,47,360,553,2220
2021-08-21,543,262,81,35,776,463,2160
2021-08-22,626,309,122,39,584,483,2163
2021-08-23,679,271,119,65,616,545,2295
2021-08-24,592,292,46,67,863,357,2217
2021-08-25,717,538,99,108,329,390,2181
2021-08-26,691,316,85,28,527,542,2189
2021-08-27,631,302,137,24,633,500,2227
2021-08-28,746,401,76,76,319,526,2144
2021-08-29,756,367,48,59,469,492,2191
2021-08-30,607,350,86,40,653,481,2217
2021-08-31,656,233,47,29,780,398,2143
2021-09-01,743,293,70,82,491,462,2141
2021-09-02,728,268,104,79,547,425,2151
2021-09-03,626,463,106,89,558,340,2182
2021-09-04,643,515,54,92,344,463,2111
2021-09-05,662,414,45,30,713,329,2193
2021-09-06,545,234,147,36,663,529,2154
2021-09-07,567,256,140,24,784,347,2118
2021-09-08,633,488,61,96,473,349,2100
2021-09-09,719,334,78,62,399,515,2107
2021-09-10,578,387,57,21,597,465,2105
2021-09-11,654,407,71,33,381,482,2028
2021-09-12,536,358,116,23,563,465,2061
2021-09-13,629,515,59,65,572,376,2216
2021-09-14,528,312,93,51,589,468,2041
2021-09-15,656,325,113,37,589,383,2103
2021-09-16,569,426,66,35,574,368,2038
2021-09-17,609,489,45,24,451,414,2032
2021-09-18,610,423,86,52,518,383,2072
2021-09-19,569,359,137,53,513,530,2161
2021-09-20,545,306,74,89,720,340,2074
2021-09-21,670,348,72,76,435,462,2063
2021-09-22,652,426,137,44,329,498,2086
2021-09-23,720,400,121,42,530,359,2172
2021-09-24,607,519,52,100,451,444,2173
2021-09-25,657,326,120,79,435,481,2098
2021-09-26,714,360,142,76,445,376,2113
2021-09-27,648,488,68,60,502,405,2171
2021-09-28,729,304,123,32,531,370,2089
2021-09-29,665,378,145,27,555,313,2083
2021-09-30,539,470,58,54,587,349,2057
2021-10-01,556,518,42,67,488,410,2081
2021-10-02,516,477,134,21,508,338,1994
2021-10-03,598,327,133,28,499,475,2060
2021-10-04,692,406,126,82,354,421,2081
2021-10-05,614,393,137,39,408,440,2031
2021-10-06,554,366,116,38,504,475,2053
2021-10-07,671,398,76,31,388,472,2036
2021-10-08,691,501,138,73,210,434,2047
2021-10-09,522,298,132,40,627,447,2066
2021-10-10,685,421,43,80,281,478,1988
2021-10-11,637,402,119,34,307,495,1994
2021-10-12,662,417,83,72,276,487,1997
2021-10-13,643,252,64,37,661,409,2066
2021-10-14,583,264,82,54,648,411,2042
2021-10-15,678,456,139,55,287,417,2032
2021-10-16,630,481,57,75,360,406,2009
2021-10-17,506,317,117,40,517,464,1961
2021-10-18,517,213,58,70,732,435,2025
2021-10-19,685,228,120,21,668,326,2048
2021-10-20,694,422,78,55,324,472,2045
2021-10-21,524,481,108,84,347,420,1964
2021-10-22,659,379,79,97,410,389,2013
2021-10-23,550,256,92,88,614,463,2063
2021-10-24,676,244,57,100,603,374,2054
2021-10-25,690,455,86,30,414,399,2074
2021-10-26,538,448,128,99,496,344,2053
2021-10-27,687,235,111,22,621,350,2026
2021-10-28,563,419,43,63,433,493,2014
2021-10-29,516,474,94,27,471,477,2059
2021-10-30,634,244,90,100,606,352,2026
2021-10-31,667,360,115,49,400,336,1927
2021-11-01,675,378,100,71,425,391,2040
2021-11-02,687,418,95,96,246,501,2043
2021-11-03,511,472,82,38,589,313,2005
2021-11-04,538,438,118,80,341,474,1989
2021-11-05,606,237,74,57,704,308,1986
2021-11-06,591,220,109,59,664,303,1946
2021-11-07,563,365,122,27,558,328,1963
2021-11-08,564,285,43,84,586,465,2027
2021-11-09,603,359,106,89,494,322,1973
2021-11-10,607,422,88,32,351,357,1857
2021-11-11,486,410,117,36,411,418,1878
2021-11-12,581,496,41,86,298,493,1995
2021-11-13,539,348,78,86,555,316,1922
2021-11-14,545,330,99,72,558,326,1930
2021-11-15,642,220,45,60,611,395,1973
2021-11-16,558,284,79,53,638,325,1937
2021-11-17,627,372,127,63,332,428,1949
2021-11-18,660,320,43,75,464,386,1948
2021-11-19,499,409,61,19,476,402,1866
2021-11-20,503,296,75,64,472,421,1831
2021-11-21,621,369,62,78,331,368,1829
2021-11-22,587,385,115,56,473,378,1994
2021-11-23,595,264,73,36,511,489,1968
2021-11-24,614,356,86,73,392,416,1937
2021-11-25,519,406,48,65,512,408,1958
2021-11-26,627,442,101,43,352,374,1939
2021-11-27,469,375,126,87,499,306,1862
2021-11-28,474,261,96,40,666,334,1871
2021-11-29,507,241,70,78,632,330,1858
2021-11-30,479,285,64,78,561,334,1801
2021-12-01,509,295,90,57,466,449,1866
2021-12-02,611,194,57,33,704,315,1914
2021-12-03,643,228,97,24,529,385,1906
2021-12-04,508,293,77,73,634,316,1901
2021-12-05,602,350,81,45,412,347,1837
2021-12-06,588,468,103,83,255,386,1883
2021-12-07,528,401,78,93,435,353,1888
2021-12-08,635,241,60,80,457,443,1916
2021-12-09,585,376,96,29,446,328,1860
2021-12-10,534,236,127,21,622,306,1846
2021-12-11,499,215,43,45,589,414,1805
2021-12-12,501,274,62,89,573,351,1850
2021-12-13,475,429,104,75,421,355,1859
2021-12-14,492,267,87,76,554,388,1864
2021-12-15,519,446,123,46,268,466,1868
2021-12-16,645,304,120,79,373,342,1863
2021-12-17,588,258,120,51,376,451,1844
2021-12-18,620,244,116,51,484,338,1853
2021-12-19,581,417,106,33,319,327,1783
2021-12-20,481,337,38,80,591,317,1844
2021-12-21,486,212,125,61,642,305,1831
2021-12-22,503,279,106,55,613,339,1895
2021-12-23,484,428,50,49,531,309,1851
2021-12-24,546,420,111,36,378,352,1843
2021-12-25,587,410,72,38,322,387,1816
2021-12-26,497,265,126,52,456,452,1848
2021-12-27,601,331,50,25,611,288,1906
2021-12-28,502,277,105,73,558,378,1893
2021-12-29,629,230,41,33,549,399,1881
2021-12-30,583,303,114,52,466,298,1816
2021-12-31,513,218,117,19,586,440,1893
2022-01-01,641,473,47,73,313,400,1947
2022-01-02,498,238,42,67,608,429,1882
2022-01-03,572,202,71,88,561,443,1937
2022-01-04,565,419,100,53,432,340,1909
2022-01-05,536,194,118,72,636,279,1835
2022-01-06,550,206,80,22,546,424,1828
2022-01-07,461,377,68,27,584,318,1835
2022-01-08,586,398,77,36,319,362,1778
2022-01-09,584,200,117,24,491,369,1785
2022-01-10,618,402,62,55,311,421,1869
2022-01-11,485,258,92,58,537,442,1872
2022-01-12,469,248,103,22,644,339,1825
2022-01-13,595,333,119,53,419,287,1806
2022-01-14,502,434,98,50,390,316,1790
2022-01-15,470,241,77,37,570,417,1812
2022-01-16,569,297,67,57,494,350,1834
2022-01-17,500,222,86,22,645,411,1886
2022-01-18,579,326,50,58,380,402,1795
2022-01-19,545,363,58,47,365,453,1831
2022-01-20,588,184,62,75,611,283,1803
2022-01-21,613,307,61,71,355,456,1863
2022-01-22,466,412,111,28,393,416,1826
2022-01-23,556,204,54,35,665,341,1855
2022-01-24,594,218,68,33,609,374,1896
2022-01-25,565,217,40,43,556,384,1805
2022-01-26,506,400,72,58,453,358,1847
2022-01-27,627,365,65,32,285,447,1821
2022-01-28,491,229,107,25,580,332,1764
2022-01-29,583,268,56,63,417,312,1699
2022-01-30,526,388,61,86,368,345,1774
2022-01-31,515,363,89,22,535,347,1871
2022-02-01,464,248,98,25,618,383,1836
2022-02-02,595,207,82,77,400,434,1795
2022-02-03,492,210,92,53,613,339,1799
2022-02-04,559,392,112,43,343,374,1823
2022-02-05,499,211,86,65,565,391,1817
2022-02-06,476,434,88,29,496,292,1815
2022-02-07,520,225,64,88,459,447,1803
2022-02-08,500,350,76,59,351,423,1759
2022-02-09,509,392,113,86,226,440,1766
2022-02-10,591,329,87,76,291,444,1818
2022-02-11,525,340,44,69,412,446,1836
2022-02-12,613,266,108,79,302,430,1798
2022-02-13,576,233,36,58,463,439,1805
2022-02-14,576,434,113,66,329,325,1843
2022-02-15,572,295,68,73,522,303,1833
2022-02-16,484,259,105,48,598,331,1825
2022-02-17,487,183,71,24,681,291,1737
2022-02-18,564,308,81,59,353,363,1728
2022-02-19,503,407,91,28,357,337,1723
2022-02-20,479,197,61,55,782,293,1867
2022-02-21,629,269,57,62,532,348,1897
2022-02-22,551,419,69,71,406,332,1848
2022-02-23,593,442,128,80,160,459,1862
2022-02-24,548,257,100,75,436,370,1786
2022-02-25,469,365,118,82,379,360,1773
2022-02-26,482,352,77,51,512,378,1852
2022-02-27,580,304,52,37,376,399,1748
2022-02-28,596,227,59,74,432,344,1732
2022-03-01,563,310,100,37,421,305,1736
2022-03-02,520,210,122,69,535,327,1783
2022-03-03,490,413,102,57,361,287,1710
2022-03-04,593,406,50,41,399,273,1762
2022-03-05,577,359,56,52,436,287,1767
2022-03-06,584,321,48,87,487,319,1846
2022-03-07,480,253,54,85,544,424,1840
2022-03-08,549,367,36,75,458,296,1781
2022-03-09,489,343,94,62,438,319,1745
2022-03-10,546,414,63,76,251,370,1720
2022-03-11,460,228,62,38,654,281,1723
2022-03-12,504,352,115,46,496,274,1787
2022-03-13,499,318,88,72,469,379,1825
2022-03-14,610,314,109,36,337,402,1808
2022-03-15,526,263,44,53,551,347,1784
2022-03-16,596,343,101,19,390,336,1785
2022-03-17,515,438,101,36,341,343,1774
2022-03-18,536,325,92,47,422,374,1796
2022-03-19,534,191,39,52,597,308,1721
2022-03-20,511,308,120,35,387,397,1758
2022-03-21,472,225,80,80,668,308,1833
2022-03-22,568,195,121,80,482,405,1851
2022-03-23,491,387,97,40,502,295,1812
2022-03-24,539,292,123,47,468,319,1788
2022-03-25,581,241,70,57,506,313,1768
2022-03-26,489,214,105,28,529,362,1727
2022-03-27,488,290,39,36,490,429,1772
2022-03-28,624,376,53,82,324,402,1861
2022-03-29,538,341,107,47,432,273,1738
2022-03-30,455,321,81,78,521,297,1753
2022-03-31,534,310,55,37,424,352,1712
2022-04-01,578,367,103,90,348,338,1824
2022-04-02,561,409,65,38,339,362,1774
2022-04-03,594,283,98,61,362,404,1802
2022-04-04,589,286,115,54,332,445,1821
2022-04-05,494,361,69,78,414,304,1720
2022-04-06,467,232,107,40,538,299,1683
2022-04-07,498,218,89,19,538,363,1725
2022-04-08,475,375,98,57,292,388,1685
2022-04-09,542,223,77,74,436,337,1689
2022-04-10,561,189,49,23,517,361,1700
2022-04-11,471,347,84,48,537,310,1797
2022-04-12,446,261,58,74,606,270,1715
2022-04-13,470,387,65,43,377,381,1723
2022-04-14,492,346,111,76,397,260,1682
2022-04-15,552,402,49,54,364,294,1715
2022-04-16,502,237,66,60,395,405,1665
2022-04-17,588,338,84,88,287,416,1801
2022-04-18,462,181,53,25,613,435,1769
2022-04-19,558,185,67,32,518,392,1752
2022-04-20,592,198,72,66,508,271,1707
2022-04-21,521,307,35,47,584,277,1771
2022-04-22,624,266,67,29,460,357,1803
2022-04-23,466,306,90,71,419,409,1761
2022-04-24,453,361,87,80,311,418,1710
2022-04-25,562,215,83,46,533,318,1757
2022-04-26,471,177,87,50,638,280,1703
2022-04-27,462,363,51,35,558,262,1731
2022-04-28,576,363,79,46,349,256,1669
2022-04-29,465,258,86,67,424,328,1628
2022-04-30,514,181,77,26,396,383,1577
2022-05-01,472,326,62,72,494,288,1714
2022-05-02,606,306,98,82,232,411,1735
2022-05-03,453,334,101,34,499,254,1675
2022-05-04,432,225,93,72,508,383,1713
2022-05-05,473,320,33,31,484,307,1648
2022-05-06,532,283,47,51,518,256,1687
2022-05-07,509,333,48,61,378,351,1680
2022-05-08,509,393,65,19,445,260,1691
2022-05-09,479,203,80,67,582,290,1701
2022-05-10,542,222,94,42,390,361,1651
2022-05-11,539,275,46,84,503,282,1729
2022-05-12,593,269,96,70,383,300,1711
2022-05-13,586,395,38,17,327,322,1685
2022-05-14,416,312,48,17,610,259,1662
2022-05-15,425,371,117,80,370,321,1684
2022-05-16,516,324,55,44,517,272,1728
2022-05-17,497,416,80,72,325,305,1695
2022-05-18,414,256,41,20,493,400,1624
2022-05-19,418,196,38,63,628,252,1595
2022-05-20,436,311,97,65,478,277,1664
2022-05-21,461,381,82,49,439,279,1691
2022-05-22,457,361,112,58,452,292,1732
2022-05-23,465,205,71,60,564,326,1691
2022-05-24,551,258,90,58,432,284,1673
2022-05-25,449,196,70,60,563,294,1632
2022-05-26,535,276,76,26,323,390,1626
2022-05-27,502,296,108,63,368,288,1625
2022-05-28,447,339,62,48,441,257,1594
2022-05-29,484,230,56,67,427,336,1600
2022-05-30,467,177,47,59,579,292,1621
2022-05-31,510,336,97,58,281,376,1658
2022-06-01,449,358,109,32,338,356,1642
2022-06-02,484,422,111,61,261,419,1758
2022-06-03,439,244,94,38,440,409,1664
2022-06-04,532,250,75,43,380,373,1653
2022-06-05,425,294,82,43,431,407,1682
2022-06-06,440,363,103,65,394,346,1711
2022-06-07,430,164,111,69,574,255,1603
2022-06-08,426,275,104,80,481,250,1616
2022-06-09,529,199,74,38,428,387,1655
2022-06-10,423,274,57,33,525,324,1636
2022-06-11,561,210,74,80,443,258,1626
2022-06-12,422,284,46,56,513,325,1646
2022-06-13,497,186,42,63,623,307,1718
2022-06-14,471,363,85,23,442,255,1639
2022-06-15,511,375,75,78,256,360,1655
2022-06-16,432,266,105,51,445,330,1629
2022-06-17,420,315,60,60,365,365,1585
2022-06-18,437,227,107,52,499,246,1568
2022-06-19,544,337,76,78,219,383,1637
2022-06-20,473,385,42,49,362,402,1713
2022-06-21,508,307,33,40,368,412,1668
2022-06-22,551,195,80,79,421,336,1662
2022-06-23,466,271,108,35,430,315,1625
2022-06-24,526,399,75,37,253,328,1618
2022-06-25,409,180,96,52,501,325,1563
2022-06-26,532,254,66,21,333,395,1601
2022-06-27,447,238,108,55,346,365,1559
2022-06-28,428,374,30,28,337,328,1525
2022-06-29,407,358,55,69,381,303,1573
2022-06-30,559,247,55,60,374,309,1604
2022-07-01,564,229,98,48,408,271,1618
2022-07-02,457,223,55,24,494,309,1562
2022-07-03,542,248,32,38,379,366,1605
2022-07-04,502,284,56,61,375,324,1602
2022-07-05,451,264,48,50,378,342,1533
2022-07-06,429,324,76,45,324,335,1533
2022-07-07,503,181,41,65,425,280,1495
2022-07-08,452,208,52,27,394,353,1486
2022-07-09,466,173,48,59,434,309,1489
2022-07-10,408,231,37,26,594,312,1608
2022-07-11,406,369,58,44,366,362,1605
2022-07-12,526,338,93,75,278,251,1561
2022-07-13,421,352,46,46,290,380,1535
2022-07-14,387,342,86,68,308,311,1502
2022-07-15,499,268,52,58,367,246,1490
2022-07-16,420,165,94,38,442,386,1545
2022-07-17,483,257,40,55,352,329,1516
2022-07-18,493,244,49,66,387,289,1528
2022-07-19,511,312,50,15,250,329,1467
2022-07-20,516,260,105,49,338,326,1594
2022-07-21,400,251,65,20,445,347,1528
2022-07-22,527,359,91,37,260,300,1574
2022-07-23,402,320,38,29,438,316,1543
2022-07-24,457,171,38,36,553,318,1573
2022-07-25,523,300,106,31,262,350,1572
2022-07-26,442,208,89,36,456,319,1550
2022-07-27,456,271,99,17,354,305,1502
2022-07-28,456,194,76,63,343,337,1469
2022-07-29,429,225,65,68,435,273,1495
2022-07-30,516,365,79,47,214,349,1570
2022-07-31,432,383,62,61,399,273,1610
2022-08-01,479,287,79,60,409,292,1606
2022-08-02,433,358,55,20,379,316,1561
2022-08-03,400,165,30,71,518,337,1521
2022-08-04,411,363,57,23,308,363,1525
2022-08-05,414,167,73,55,449,373,1531
2022-08-06,394,361,53,35,359,291,1493
2022-08-07,385,220,36,17,474,322,1454
2022-08-08,427,282,37,27,411,383,1567
2022-08-09,442,181,108,23,508,310,1572
2022-08-10,479,308,60,54,247,374,1522
2022-08-11,486,223,48,26,487,284,1554
2022-08-12,449,315,55,44,395,302,1560
2022-08-13,441,382,90,44,267,365,1589
2022-08-14,529,320,93,19,363,294,1618
2022-08-15,422,173,84,25,595,371,1670
2022-08-16,420,313,37,40,428,263,1501
2022-08-17,516,236,104,52,246,347,1501
2022-08-18,448,261,66,37,427,299,1538
2022-08-19,490,329,66,16,336,368,1605
2022-08-20,486,359,87,60,365,257,1614
2022-08-21,441,183,54,43,635,274,1630
2022-08-22,470,278,86,19,489,313,1655
2022-08-23,422,315,34,69,438,298,1576
2022-08-24,552,191,34,35,422,349,1583
2022-08-25,473,212,93,16,440,348,1582
2022-08-26,485,360,100,19,328,247,1539
2022-08-27,483,264,36,45,398,273,1499
2022-08-28,532,209,97,38,418,259,1553
2022-08-29,450,373,57,47,442,277,1646
2022-08-30,462,237,46,28,533,231,1537
2022-08-31,464,329,102,74,222,343,1534
2022-09-01,444,179,66,65,400,378,1532
2022-09-02,402,318,55,64,460,243,1542
2022-09-03,496,199,94,65,367,240,1461
2022-09-04,465,319,34,22,435,233,1508
2022-09-05,504,326,36,26,355,253,1500
2022-09-06,399,161,57,34,405,346,1402
2022-09-07,470,279,42,15,393,267,1466
2022-09-08,457,270,93,23,356,319,1518
2022-09-09,506,196,82,40,412,303,1539
2022-09-10,397,167,96,17,551,251,1479
2022-09-11,482,203,34,66,390,331,1506
2022-09-12,451,236,31,49,510,282,1559
2022-09-13,464,263,101,66,320,280,1494
2022-09-14,446,369,72,39,233,344,1503
2022-09-15,496,291,77,26,336,253,1479
2022-09-16,426,365,83,42,219,346,1481
2022-09-17,415,338,54,18,300,304,1429
2022-09-18,465,298,69,35,295,381,1543
2022-09-19,512,348,96,49,246,323,1574
2022-09-20,532,325,49,28,351,242,1527
2022-09-21,464,238,53,29,474,255,1513
2022-09-22,464,359,83,37,339,261,1543
2022-09-23,421,183,44,61,561,280,1550
2022-09-24,439,351,44,64,306,357,1561
2022-09-25,485,235,52,29,406,252,1459
2022-09-26,544,202,57,48,331,392,1574
2022-09-27,541,374,36,24,345,249,1569
2022-09-28,553,394,108,16,274,257,1602
2022-09-29,550,381,49,22,269,342,1613
2022-09-30,418,188,32,75,450,385,1548
2022-10-01,426,296,35,33,426,326,1542
2022-10-02,496,263,99,34,380,279,1551
2022-10-03,474,343,40,72,327,275,1531
2022-10-04,425,355,56,42,429,239,1546
2022-10-05,469,184,65,48,442,333,1541
2022-10-06,410,233,88,44,358,342,1475
2022-10-07,417,313,58,25,429,310,1552
2022-10-08,424,320,57,24,343,365,1533
2022-10-09,462,314,32,50,403,332,1593
2022-10-10,527,252,109,40,366,280,1574
2022-10-11,454,256,61,64,362,349,1546
2022-10-12,402,241,44,49,554,252,1542
2022-10-13,520,322,85,31,303,284,1545
2022-10-14,531,287,87,18,245,362,1530
2022-10-15,381,345,43,51,323,352,1495
2022-10-16,443,206,100,54,331,318,1452
2022-10-17,416,345,83,44,357,296,1541
2022-10-18,536,179,65,68,470,310,1628
2022-10-19,542,182,67,72,356,365,1584
2022-10-20,484,282,84,26,370,324,1570
2022-10-21,481,381,97,29,277,297,1562
2022-10-22,451,247,91,48,510,264,1611
2022-10-23,461,196,84,17,552,258,1568
2022-10-24,473,254,86,77,473,264,1627
2022-10-25,422,311,79,21,318,372,1523
2022-10-26,512,247,95,15,382,229,1480
2022-10-27,405,178,101,64,473,288,1509
2022-10-28,506,260,95,21,411,294,1587
2022-10-29,458,324,43,30,333,335,1523
2022-10-30,527,235,98,44,355,269,1528
2022-10-31,536,199,86,29,435,257,1542
2022-11-01,483,231,80,33,366,301,1494
2022-11-02,459,365,63,40,241,325,1493
2022-11-03,494,239,68,72,332,311,1516
2022-11-04,508,259,77,15,312,302,1473
2022-11-05,424,160,73,20,574,242,1493
2022-11-06,420,178,56,37,463,284,1438
2022-11-07,528,359,46,38,233,339,1543
2022-11-08,489,215,73,34,339,339,1489
2022-11-09,513,315,84,50,315,226,1503
2022-11-10,425,212,43,21,432,361,1494
2022-11-11,466,234,36,69,355,323,1483
2022-11-12,433,304,34,54,359,275,1459
2022-11-13,504,361,70,30,159,338,1462
2022-11-14,413,259,56,16,435,307,1486
2022-11-15,381,201,37,27,536,244,1426
2022-11-16,482,222,101,27,322,318,1472
2022-11-17,452,199,41,72,387,312,1463
2022-11-18,520,226,84,50,285,323,1488
2022-11-19,442,193,78,37,435,259,1444
2022-11-20,351,230,34,62,439,265,1381
2022-11-21,507,343,101,72,151,315,1489
2022-11-22,450,337,75,47,205,363,1477
2022-11-23,407,177,73,38,457,357,1509
2022-11-24,484,291,88,32,305,229,1429
2022-11-25,413,289,42,25,320,347,1436
2022-11-26,414,239,91,17,387,278,1426
2022-11-27,394,212,70,37,391,347,1451
2022-11-28,470,228,46,55,365,343,1507
2022-11-29,521,254,97,69,249,303,1493
2022-11-30,430,197,100,37,384,316,1464
2022-12-01,369,250,95,63,416,230,1423
2022-12-02,377,174,30,67,532,258,1438
2022-12-03,502,312,71,21,328,238,1472
2022-12-04,395,158,76,17,445,309,1400
2022-12-05,467,302,58,62,296,251,1436
2022-12-06,472,214,40,53,284,342,1405
2022-12-07,408,355,62,62,329,289,1505
2022-12-08,490,220,50,20,455,230,1465
2022-12-09,447,346,71,23,355,232,1474
2022-12-10,413,299,90,69,386,227,1484
2022-12-11,443,189,44,29,488,226,1419
2022-12-12,377,153,96,25,505,309,1465
2022-12-13,434,315,72,47,282,305,1455
2022-12-14,455,283,89,18,293,319,1457
2022-12-15,361,157,44,47,459,336,1404
2022-12-16,454,301,31,65,259,304,1414
2022-12-17,387,257,80,15,399,370,1508
2022-12-18,364,331,36,30,346,317,1424
2022-12-19,509,286,50,27,302,320,1494
2022-12-20,375,215,93,58,460,247,1448
2022-12-21,370,355,92,38,362,247,1464
2022-12-22,467,154,48,28,387,335,1419
2022-12-23,499,198,84,47,359,264,1451
2022-12-24,433,199,29,57,408,264,1390
2022-12-25,450,237,82,41,251,287,1348
2022-12-26,425,217,59,37,424,273,1435
2022-12-27,490,363,44,69,255,252,1473
2022-12-28,518,341,73,72,231,263,1498
2022-12-29,387,260,95,52,397,233,1424
2022-12-30,418,363,86,29,231,328,1455
2022-12-31,503,198,36,43,447,217,1444
2023-01-01,496,201,79,68,347,233,1424
2023-01-02,459,285,33,30,344,312,1463
2023-01-03,451,183,33,69,358,329,1423
2023-01-04,468,260,41,29,284,325,1407
2023-01-05,343,293,75,21,350,244,1326
2023-01-06,447,202,43,65,468,220,1445
2023-01-07,462,160,77,58,371,254,1382
2023-01-08,474,295,70,19,327,259,1444
2023-01-09,419,291,89,59,247,358,1463
2023-01-10,371,290,73,46,313,325,1418
2023-01-11,450,316,93,27,256,251,1393
2023-01-12,417,338,46,59,271,249,1380
2023-01-13,372,348,54,39,283,298,1394
2023-01-14,353,146,76,35,528,213,1351
2023-01-15,439,211,44,39,346,285,1364
2023-01-16,445,319,88,47,364,259,1522
2023-01-17,445,253,53,27,372,298,1448
2023-01-18,477,208,33,17,470,214,1419
2023-01-19,396,156,35,22,545,245,1399
2023-01-20,414,291,93,35,360,241,1434
2023-01-21,378,214,68,51,372,293,1376
2023-01-22,409,151,52,43,397,340,1392
2023-01-23,468,269,69,56,264,297,1423
2023-01-24,469,328,41,25,214,270,1347
2023-01-25,365,207,44,65,379,273,1333
2023-01-26,412,199,64,51,339,342,1407
2023-01-27,377,338,74,51,299,231,1370
2023-01-28,381,329,38,40,366,250,1404
2023-01-29,376,267,68,23,447,272,1453
2023-01-30,499,170,35,31,423,273,1431
2023-01-31,440,318,49,70,293,236,1406
2023-02-01,369,277,91,15,399,260,1411
2023-02-02,404,244,58,16,379,237,1338
2023-02-03,449,180,51,32,296,307,1315
2023-02-04,426,190,32,42,390,234,1314
2023-02-05,402,280,64,56,362,289,1453
2023-02-06,382,188,51,17,484,289,1411
2023-02-07,390,226,32,30,418,303,1399
2023-02-08,356,299,66,42,365,273,1401
2023-02-09,446,149,37,14,411,319,1376
2023-02-10,379,176,37,43,419,336,1390
2023-02-11,366,182,73,27,506,232,1386
2023-02-12,360,189,88,27,440,261,1365
2023-02-13,382,313,58,57,268,355,1433
2023-02-14,453,298,94,38,188,289,1360
2023-02-15,468,344,56,14,306,242,1430
2023-02-16,383,171,77,35,516,214,1396
2023-02-17,455,340,94,45,185,287,1406
2023-02-18,471,160,58,25,400,257,1371
2023-02-19,475,153,56,51,421,217,1373
2023-02-20,397,349,45,64,266,288,1409
2023-02-21,460,244,44,37,388,238,1411
2023-02-22,400,194,28,57,348,311,1338
2023-02-23,418,164,69,25,425,237,1338
2023-02-24,349,234,48,21,411,332,1395
2023-02-25,446,152,40,28,430,347,1443
2023-02-26,483,198,29,52,424,245,1431
2023-02-27,447,201,40,30,346,328,1392
2023-02-28,384,192,77,52,327,332,1364
2023-03-01,342,186,81,38,502,203,1352
2023-03-02,412,166,88,17,433,259,1375
2023-03-03,436,188,93,43,377,241,1378
2023-03-04,368,297,80,51,277,252,1325
2023-03-05,351,219,69,55,340,335,1369
2023-03-06,423,349,90,66,197,274,1399
2023-03-07,415,322,51,26,326,235,1375
2023-03-08,385,222,34,65,447,232,1385
2023-03-09,364,249,94,31,416,231,1385
2023-03-10,409,307,83,30,221,339,1389
2023-03-11,471,220,77,27,244,341,1380
2023-03-12,489,307,79,29,236,280,1420
2023-03-13,459,288,93,70,193,316,1419
2023-03-14,453,279,50,52,162,323,1319
2023-03-15,348,222,36,49,338,285,1278
2023-03-16,416,180,49,64,297,290,1296
2023-03-17,433,215,51,22,419,238,1378
2023-03-18,443,203,58,67,363,212,1346
2023-03-19,495,186,97,15,326,307,1426
2023-03-20,389,231,80,35,353,339,1427
2023-03-21,384,242,76,18,394,251,1365
2023-03-22,455,211,80,66,271,260,1343
2023-03-23,396,263,44,61,282,281,1327
2023-03-24,373,139,57,49,470,246,1334
2023-03-25,350,220,63,16,382,217,1248
2023-03-26,423,150,69,34,441,223,1340
2023-03-27,479,328,28,18,251,323,1427
2023-03-28,419,220,55,35,290,286,1305
2023-03-29,347,160,27,61,521,197,1313
2023-03-30,361,280,33,64,321,264,1323
2023-03-31,397,277,52,48,309,227,1310
2023-04-01,358,240,63,36,271,309,1277
2023-04-02,410,234,55,38,303,283,1323
2023-04-03,464,321,39,55,242,216,1337
2023-04-04,352,194,71,27,407,202,1253
2023-04-05,338,222,70,53,356,231,1270
2023-04-06,337,207,81,47,392,214,1278
2023-04-07,422,296,75,37,205,248,1283
2023-04-08,345,255,40,44,310,279,1273
2023-04-09,420,237,85,33,324,200,1299
2023-04-10,450,213,49,39,308,266,1325
2023-04-11,428,180,76,33,240,291,1248
2023-04-12,414,208,79,49,214,264,1228
2023-04-13,401,165,73,39,311,232,1221
2023-04-14,357,126,47,31,413,209,1183
2023-04-15,391,226,79,53,191,268,1208
2023-04-16,386,266,63,59,292,268,1334
2023-04-17,455,226,84,58,197,288,1308
2023-04-18,331,202,73,49,388,220,1263
2023-04-19,348,182,28,57,400,215,1230
2023-04-20,410,272,65,50,210,247,1254
2023-04-21,394,192,76,30,340,252,1284
2023-04-22,423,176,32,14,382,286,1313
2023-04-23,410,317,87,45,178,270,1307
2023-04-24,366,181,65,21,302,291,1226
2023-04-25,416,309,80,18,181,312,1316
2023-04-26,431,284,37,58,295,230,1335
2023-04-27,431,289,67,59,204,222,1272
2023-04-28,365,310,28,51,239,314,1307
2023-04-29,391,253,86,54,245,299,1328
2023-04-30,364,219,52,53,295,284,1267
2023-05-01,390,225,82,24,227,291,1239
2023-05-02,335,173,63,21,372,316,1280
2023-05-03,350,246,37,55,309,250,1247
2023-05-04,327,225,41,49,325,256,1223
2023-05-05,405,261,76,35,248,201,1226
2023-05-06,410,204,75,18,245,316,1268
2023-05-07,360,189,84,47,394,205,1279
2023-05-08,361,306,91,43,289,231,1321
2023-05-09,435,148,70,35,355,234,1277
2023-05-10,351,258,49,34,341,216,1249
2023-05-11,320,188,70,17,447,218,1260
2023-05-12,409,293,29,56,284,207,1278
2023-05-13,402,225,67,57,145,282,1178
2023-05-14,358,209,30,32,401,226,1256
2023-05-15,370,188,29,46,432,218,1283
2023-05-16,332,181,57,35,384,317,1306
2023-05-17,411,300,57,31,256,240,1295
2023-05-18,318,198,52,41,380,233,1222
2023-05-19,335,188,64,16,448,210,1261
2023-05-20,406,196,35,33,305,270,1245
2023-05-21,434,166,79,33,276,253,1241
2023-05-22,375,285,41,53,261,291,1306
2023-05-23,344,152,52,26,413,185,1172
2023-05-24,379,212,44,29,318,180,1162
2023-05-25,395,293,70,23,178,245,1204
2023-05-26,361,177,39,19,402,270,1268
2023-05-27,389,207,54,44,259,274,1227
2023-05-28,404,229,63,58,302,205,1261
2023-05-29,345,153,34,61,502,195,1290
2023-05-30,311,293,32,37,357,192,1222
2023-05-31,330,228,56,59,252,294,1219
2023-06-01,398,214,50,49,314,212,1237
2023-06-02,411,154,58,36,281,241,1181
2023-06-03,336,223,48,16,369,195,1187
2023-06-04,385,121,72,31,384,187,1180
2023-06-05,395,163,82,52,266,313,1271
2023-06-06,375,258,48,25,271,247,1224
2023-06-07,324,195,78,26,384,204,1211
2023-06-08,308,276,36,20,358,213,1211
2023-06-09,296,185,74,57,333,234,1179
2023-06-10,337,162,27,37,316,292,1171
2023-06-11,347,211,54,37,340,238,1227
2023-06-12,418,225,62,57,302,191,1255
2023-06-13,380,122,76,34,285,288,1185
2023-06-14,237,128,31,7,165,135,703
